cd	코드
code	코드
nm	명
name	명
saup	사업
DISEN	연결체

BUF	조사료

GB	구분
BIZ	사업
MNGMTSYS	경영체

DRYGRASS	건초
MCT	제조비
SILAGE	사일리지

#행정표준용어.
ONE	1
OCT	10월
N119SC	119안전신고센터
NOV	11월
DEC	12월
NJAN	13월
NFEB	14월
JAN	1월
FSLS	1종시설물
PRMRFRG	1차냉각재
DSPPRD	1회용품
TWO	2
TEU	20피트컨테이너단위
FRD21	21세기프론티어연구개발사업
24HAMR	24시간전적하목록제출규정
FEB	2월
SCLLS	2종시설물
SCD	2차
SCDRF	2차냉각재
SRGBTRY	2차전지
SECNP	2차통지처
THREE	3
MAR	3월
FOUR	4
FEU	40피트컨테이너단위
FRIVR	4대강
FEINSR	4대보험
FEINSR	4대사회보험
APR	4월
FIVE	5
MAY	5월
SIX	6
SSGM	6시그마
JUN	6월
SPTLKS	6자회담
SEVEN	7
JULY	7월
EIGHT	8
AUG	8월
NINE	9
SEP	9월
A4P	A4
A4P	A4지
AAIC	AAIC
AWBDRT	ABR
ABS	ABS
ALTRCRT	AC
_ADSL	ADSL
_APEC	APEC
_API	API
ARS	ARS
_AS	AS
_ASEAN	ASEAN
ASP	ASP
ATACRT	ATA까르네
ATACIB	ATA까르네발급단체
ATACIC	ATA까르네발급업체
ATACGB	ATA까르네보증단체
ATC	ATC
_B2B	B2B
BTCHEXOR	BATCH구동자
BBS	BBS
_BIT	BIT
BIT	BIT
_BK21	BK21
_BL	BL
BMS	BMS
BOM	BOM
IPIRB	BSE관련수입금지품목
_C4I	C4I
CCTV	CCTV
CD	CD
_CIS	CIS
_CO2	CO2
COBCOMP	COB업체
CPU	CPU
CS	CS
CSR	CSR
DBMS	DBMS
_DDA	DDA
DMB	DMB
_DNA	DNA
_DOI	DOI
_DW	DW
ESEAL	eSeal
EAI	EAI
EDA	EDA
_EITC	EITC
EPID	EPID
ERASYS	ERA시스템
ETT	ETT
_FAQ	FAQ
FCL	FCL
FCCL	FCL컨테이너화물
FOB	FOB
_FTA	FTA
FTP	FTP
_G2B	G2B
_G4B	G4B
_G4C	G4C
_GDP	GDP
GIS	GIS
_GMO	GMO
_GPS	GPS
HLPDSK	HELPDESK
HPA	HPA
_HTML	HTML
_HW	HW
HDWRSC	HW자원
_IBRD	IBRD
ID	ID
_IDA	IDA
_IEA	IEA
_ILC	ILC
_IMO	IMO
_IP	IP
_IPV6	IPV6
_ISBN	ISBN
_ISO	ISO
_ISSN	ISSN
_IT	IT
_ITA	ITA
ITATL	ITA도구
ITAVS	ITA비전
ITAP	ITA원칙
ITIDSTR	IT산업
JPEG	JPEG
KIMSCL	KIMS분류
KIS	KIS
KMS	KMS
KOTRA	KOTRA
_LAN	LAN
LTCCL	LCL컨테이너화물
LOG	LOG
LSD	LSD
MACADRS	MAC주소
MBS	MBS
MCM	MC
_NON	NON
OCR	OCR
_OECD	OECD
_OECF	OECF
_OSPF	OSPF
PDF	pdf
PTRSC	PART자원
_PC	PC
PDA	PDA
PPM	PPM
RFID	RFID
RGB	RGB
RSS	RSS
SNS	SNS
_SOC	SOC
SQL	SQL
SR	SR
SSO	SSO
_SW	SW
SWOT	SWOT분석
SFTRSC	SW자원
TBS	TBS
_TCP	TCP
_TCPIP	TCPIP
TCTOE	TCTOE
_TNT	TNT
TOE	TOE
TOPIS	TOPIS
_TV	TV
UCC	UCC
_UCI	UCI
UCR	UCR
_UN	UN
_UNCTAD	UNCTAD
_UNDP	UNDP
_UNESCO	UNESCO
_URL	URL
_USA	USA
VIIST	V표시용기
_WAN	WAN
_W	WATT
_WBS	WBS
_WHO	WHO
_WTO	WTO
_WEB	WWW
WCS	W표시용기
_XML	XML
XAXS	X축
YAXS	Y축
PC	가
ADSBTR	가감
TMPOPN	가개통
PC	가격
PCFLT	가격변동
PCPNTTM	가격시점
PCINDSYS	가격표시제
FLLN	가계
PRSNLCHK	가계수표
PRCSS	가공
PROTRD	가공무역
PRCSPD	가공물
PRCSFD	가공식품
PRCSBIZ	가공업
PRCSPD	가공제품
PRCSPD	가공품
BRDG	가교
HSHLD	가구
FRNTR	가구
HSHLDR	가구주
DFWS	가금
DEPOST	가납
POSBL	가능
POSBLTY	가능성
OPR	가동
ORMPM	가동시간
STRPDL	가두판매
ROFE	가득율
PRSRGST	가등기
WIDTH	가로
STTREE	가로수
MCTT	가료
POWD	가루
POSBL	가망
POSBLTY	가망성
JNG	가맹
JNCDCMT	가맹계약서
JNNT	가맹금
JNGHDQRTRS	가맹본부
FRNCHS	가맹사업
MRHST	가맹점
MRBCRB	가맹점사업자
MMBRSWRT	가맹점운영권
JNTRY	가맹중개인
JGTRS	가맹지역본부
JNGCDIDT	가맹희망자
ALIAS	가명
DRGHT	가뭄
MVBTY	가반식
WIG	가발
BAG	가방
SSCHNGE	가변
CVROD	가변차로
TMPPSV	가보존
YN	가부
DBN	가분급부
WSFS	가사
HSKP	가사
DCCS	가사노동
FMLY	가사소송
ADDI	가산
ADAMT	가산금
SPRED	가산금리
ADAMT	가산금액
ADTX	가산세
ADTX	가산세금
ADDIFEE	가산수수료
VIRTL	가상
PAROLE	가석방
INSTL	가설
FSPSN	가설인명
INSTLR	가설자
TMPRSR	가설재
PLSTC	가소성
ACCL	가속
AC	가속도
MNTSS	가수
GAS	가스
GASFCT	가스공급시설
GBYWBS	가스도매사업
GPST	가스사용시설
GMR	가스상물질류
GRRNG	가스설비
GSPMFR	가스용품제조사업자
GFD	가스전
GASPLANT	가스플랜트
BREAST	가슴
VSRAY	가시광선
VSRAY	가시선
VSBLCHN	가시채널
PRN	가압
PRSSZR	가압류
AMOUNT	가액
CMBSTB	가연성
CMBSTBGAS	가연성가스
CTGRTS	가연성가스저온저장탱크
HTNG	가열
HTADH	가열응착
HTMVL	가열탈착
HUSE	가옥
USEFUL	가용
AUTUMN	가을
SBSCRB	가입
SRBCT	가입금
SRBCT	가입비
SSMMS	가입수수료
SBSCRPTN	가입신청
SSBYP	가입유형
SRBDE	가입일
SRBDE	가입일자
SBSCRBER	가입자
IMEM	가입자내부식별자
SSCRN	가입자선로
SSCBL	가입제한
SCBT	가입해지
ELPRD	가전
ELPRD	가전제품
ADDPNT	가점
TMR	가접수
ASUMP	가정
HOME	가정
HMSNT	가정구성원
HTVT	가정보호사건
FLYT	가정의례
HMVLN	가정폭력
HMCMVLN	가정폭력범죄
HVCD	가정폭력행위자
FAMILY	가족
FLN	가족계획사업
FAMILYLAW	가족법
FLHBTR	가족어선원
FAMILYSYSTEM	가족제도
TMPEND	가종료
AGRVTN	가중
AGRPNL	가중처벌
WGHTVAL	가중치
WGHVR	가중평균
PRSXCT	가집행
STVC	가집행선고
PRVISNL	가처분
LVSTCK	가축
LVSTCKEXCRS	가축분뇨
LKNTS	가축전염병
DSSSL	가축통계조사
LVM	가출
PAROL	가출소
DRRSN	가출인
VALU	가치
OSV	가치관
VIOVAT	가치혁신
HSSH	가택수색
_GATT	가트
WRNGDO	가해
WRNGDOR	가해자
IFCDT	가해학생
WRKMINE	가행광산
CRUEL	가혹행위
PRSRSTR	가환부
EVRGR	각급
ENDNST	각급기관
ENFS	각급학교
ANGLE	각도
CBORD	각령
CNMSTR	각료
SQRB	각목
ERYND	각종
FTNT	각주
RJECT	각하
SQRSHP	각형
EVRDR	각호
LIVER	간
INTRVL	간격
IFMGTHDCS	간담회
LEADER	간부
ORGNZR	간사
TDLAND	간석지
MNN	간선
IRYST	간선급행버스체계
SMPLFC	간소화
HRTS	간염
ADLTRY	간음
SIMPLCTY	간이
SYRR	간이공판절차
CLCRT	간이법원
SPTR	간이상수도
SMDVR	간이인도
SSAUC	간장
INDRT	간접
IDNTG	간접교사
INDRCT	간접비
ICTX	간접세
ICNLT	간접책임
REGARD	간주
EPLPSY	간질
LRCL	간척
RCLLND	간척지
SPY	간첩
ADCRM	간통죄
SGNBRD	간판
PBLCATE	간행
PBLICTN	간행물
NRS	간호
NURSE	간호사
NFFL	간호사무관
NSAID	간호조무사
TRBL	갈등
DRGH	갈수
REPLC	갈음
RDC	감가
DPRC	감가비
DPRC	감가상각
PCRDCAMD	감가수정
SENSE	감각
TNGRN	감귤
PRSMMN	감나무
MNG	감독
MANGR	감독자
IMPRS	감동
OUTAGE	감량
REDUCE	감량화
SPRVISN	감리
SPVMNGMT	감리관리
SPRVISOR	감리원
SPRVISOR	감리자
SPRSYS	감리제도
RDCXPT	감면
DIVRDC	감배
SLYRD	감봉
AUDIT	감사
ADTR	감사관
ISPST	감사기관
BAI	감사원
ADTOR	감사인
ADTOR	감사자
IPSPR	감사책임자
SBTRACT	감산
DCRS	감소
DCRSQY	감소수량
DCRSAMT	감소액
RDCSPD	감속
DCRES	감손
DCRS	감쇄
WLSBM	감수
MNTRG	감시
ARYRS	감시권
MNRP	감시용
WTCHMAN	감시원
DSCRN	감식
DCMPRS	감압
DCMPRSEQP	감압설비
RDCAMT	감액
INFC	감염
ICD	감염병
INFCTS	감염성
INFCWSTE	감염성폐기물
IFCD	감염증
RDCFRC	감원
POTATO	감자
MTCRD	감자차액
DMRTR	감점
APPRSL	감정
APRPC	감정가
APRPC	감정가격
APPRSR	감정사
APRPN	감정원
APRSR	감정인
EXRTW	감정증인
APASMT	감정평가
PRPRAPR	감정평가사
ESTMS	감정평가업
APBZOP	감정평가업자
APSPRT	감정허가장
PRCP	감지
SENSOR	감지기
DCVHCL	감차
INSPC	감찰
INSPCTR	감찰관
INTRCPT	감청
ICPSNQ	감청설비
REDC	감축
SEAWRTHN	감항능력
ARWRTH	감항성
ARTHCRT	감항증명
CMMT	감형
SPRINTEND	감호
GEIT	갑근세
FLDGT	갑문
GEIT	갑종근로소득세
HHTFT	갑종사태
UPDKLOD	갑판상부적재
DCKLD	갑판하부적재
VALUE	값
VALDOMN	값영역
SHDRD	갓길
RAPE	강간
DLBR	강구
IN	강도
BRGLR	강도
VNCM	강력범죄
CDCNDT	강령
FRPCH	강매
INSTRCTR	강사
GANGSEO	강서
PRCPT	강수
TNCRS	강습
LCTR	강연
ENFRC	강요
RAIN	강우
RNFLLMT	강우계
STRMWTER	강우유출수
GW	강원
GW	강원도
GANGNEUNG	강원도강릉시
GWGOSEONG	강원도고성군
DONGHAE	강원도동해시
SAMCHEOK	강원도삼척시
SOKCHO	강원도속초시
YANGGU	강원도양구군
YANGYANG	강원도양양군
YEONGWOL	강원도영월군
WONJU	강원도원주시
INJE	강원도인제군
JEONGSEON	강원도정선군
CHEORWON	강원도철원군
CHUNCHEON	강원도춘천시
TAEBAEK	강원도태백시
PYEONGCHANG	강원도평창군
HONGCHEON	강원도홍천군
HWACHEON	강원도화천군
HOENGSEONG	강원도횡성군
LCTRE	강의
LCTRUM	강의실
DRDPT	강임
SRLWR	강전류전선
ENFRC	강제
CPRSN	강제경매
CPRY	강제보험
CPRCLC	강제징수
CPRSS	강제처분
CPSY	강제투표
MTRYW	강행법
STRNGTH	강화
CLTV	개간
OPNNG	개관
CNCPT	개념
DEVCNTRY	개도국
OUTL	개략
IMPRV	개량
RENAME	개명
OPENGT	개문
DEVLOP	개발
DEVCNTRY	개발도상국
DEVCNTRY	개발도상국가
DYGR	개발밀도관리구역
DLPR	개발부담금
DWK	개발사업
DEVLOPPROFIT	개발이익
DVLPR	개발자
OPN	개방
OPEN	개방형
ONS	개방형직위
OPLT	개방화장실
INDVDLZ	개별
INNMVL	개별가구소득평가액
PNILP	개별공시지가
INPANTE	개별납부서
ICM	개별법
ISHLWK	개별연구개발사업
RPAIR	개보수
BGPRC	개산가격
BRFPR	개산원가
RWRT	개서
IMPRVM	개선
ESTBL	개설
APLICNT	개설의뢰인
ESTBLDE	개설일
ESTER	개설자
GNTRX	개성공단
REPR	개수
CO	개수
BEGIN	개시
BFTRT	개시전
OPBIZ	개업
PROBL	개연성
SUMRY	개요
MONTH	개월
INDVDL	개인
IDCRNS	개인과외교습자
INDVDLINVNT	개인발명가
IDSR	개인부담금
PIN	개인식별번호
_PC	개인용컴퓨터
INDVDLLCINFO	개인위치정보
IVLCT	개인위치정보주체
INDVDLINFO	개인정보
IDINFOFILE	개인정보화일
INDVDLRETIREACNUT	개인퇴직계좌
INDVAMS	개인화기
REAPOINT	개임
INTRVN	개입
ITNGH	개입권
ITRB	개입의무
REMAK	개작
REBRL	개장
ONSS	개장
DECLWR	개전
REFORM	개정
RVSBIL	개정안
REMODEL	개조
OPENG	개찰
RCLAMT	개척
BROOK	개천
OPOFC	개청
CUTOFHR	개청시간
INDVD	개체
POPULTN	개체군
OPMT	개최
HSTCNT	개최국가
INSTIT	개최시설
INSTUTDIF	개최시설상세정보
OPAR	개최지역
OPTO	개최회담
REBLD	개축
RETITL	개칭
OPTRFC	개통
OPCMCT	개통
OPENER	개통자
OPNY	개통지연
ONPY	개통희망일
REORGAN	개편
RORGN	개폐
SCT	개폐소
XMNTCK	개표
TCKBR	개표구
CGNLS	개품운송계약
OPT	개항
TITPRT	개항장
REFRM	개혁
OPNMT	개회
OBJCTVTY	객관
OBJCT	객관식
RUM	객실
GPFS	객원교수
PTRAIN	객차
OBJECT	객체
FORGN	갯벌
CO	갯수
RGNR	갱생
UPDT	갱신
UPDUSR	갱신자
GNGIN	갱입
GNGOUT	갱출
ERYSP	거대선
DELNG	거래
DLPC	거래가
DLPC	거래가격
DCNT	거래건수
DLAMT	거래금액
TECM	거래사례비교법
TRFTAX	거래세
EXCHN	거래소
DLNT	거래수량
DDT	거래일
DEALER	거래자
BFDL	거래전
CNDSALE	거래조건
BCNC	거래처
TYPTRAN	거래형태
AFTDL	거래후
DSTNC	거리
BGTRE	거목
GVRNC	거버넌스
REJECT	거부
RFUSRT	거부권
TRTS	거북
ONDSS	거소
RTGHL	거소지정권
MACRO	거시
REJECT	거절
RJCTR	거절자
PRTEST	거절증서
POSITN	거점
RESIDE	거주
RESID	거주성
RESIDNT	거주자
RESDNC	거주지
FLS	거짓
DWLLG	거처
DFR	거치
DFTRTE	거치관세율
DRMN	거치금액
GPIOD	거치기간
AFSETY	거치담보
DFRINSRNC	거치보험
HEALTH	건강
HTHM	건강가정
HFQF	건강가정사
HLHMB	건강가정사업
HLTHCHKP	건강검사
HTFS	건강기능식품
HLTHINS	건강보험
ESTCNT	건국
OMRNTFD	건국훈장
CRSNG	건널목
CSBY	건당
ERC	건립
BULD	건물
EQB	건물군
BLDSTE	건물대지
BULDDONG	건물동
BDNBR	건물번호
BDTYP	건물유형
BLDNR	건물주
BDH	건물호
CSBY	건별
CNSTRC	건설
CNTWRK	건설공사
ISDTR	건설공사지원통합정보체계
MOCT	건설교통부
CCRR	건설근로자
CTCQ	건설기계
CMMAACT	건설기계관리법
CMMOACT	건설기계저당법
CSTSK	건설기술
CRSVC	건설기술용역
CRGR	건설기술자
CNSTRCBSNSMANAGE	건설사업관리
CNSTRCINDUST	건설산업
BNSTY	건설업
CSYN	건설업월평균임금
CTCRD	건설업자
CSRS	건설용역업
CTRR	건설위탁
CNSTRCINTR	건설이자
CNSTRNHOUS	건설임대주택
CNSTRCWSTE	건설폐기물
CNSTRCWSTEPRCSNGFCLTY	건설폐기물처리시설
CNSTRCWSTEPRCSNGBSNS	건설폐기물처리업
CO	건수
DYCS	건식
SUGEST	건의
CVLCAM	건의성민원
PRPSTN	건의안
SNDNS	건전
SND	건전성
BTRY	건전지
CDWPTR	건제
CNSTR	건조
BLD	건조물
BULDER	건조자
BILDNG	건축
BILD	건축물
QLFARKT	건축사
BLWN	건축주
BLDAR	건평
BTL	건폐
BDTLDR	건폐율
ARREST	검거
SOOT	검댕
WGHER	검량사
INSPCTN	검문
CHKPT	검문소
PRSEC	검사
INSPCT	검사
EXAMER	검사관
TSTBSDE	검사기준일
STND	검사대
PSTI	검사대상자
INSPMET	검사방법
INSPOFC	검사소
INSCHRG	검사수수료
INSPCR	검사인
ATEINSPC	검사입회
INSPTR	검사자
ACBIS	검사주무
EXAM	검사증
MAROFCE	검사지정관
CUSTINSP	검사직원
ENDSC	검사필
SEARCH	검색
RUMTECH	검색기법
SRCHWRD	검색어
ACPTNC	검수
CHCKR	검수사
BUSSURY	검수업
EMRPS	검시
POSTMRTM	검안
QRANT	검역
QSQUAR	검역대상물품
QURON	검역소
QRTFPL	검역시행장
QUAINFO	검역안내
QURAN	검역원
CERQUA	검역증
PMI	검역필
QRPRT	검역항
CNSRSHIP	검열
STMPAPR	검인
ATHRZ	검정
MEAWEG	검정검량
QLFEXM	검정고시
AHDK	검정도서
SURYOR	검정인
TDLSTT	검조소
VRIFY	검증
VRIFER	검증자
MDEXMN	검진
EXMN	검찰
PRSCOFCL	검찰공무원
SPPO	검찰청
DETECT	검출
SVFTR	검측감리
MTINSP	검침
EXMNT	검토
CHCKER	검토자
NTCE	게시
BBSCTT	게시글
NTT	게시물
NCLTS	게시시설
NTCR	게시자
BBS	게시판
DISPL	게양
GATEB	게이트볼
GTWY	게이트웨이
GTPR	게이트키퍼
GAME	게임
GFTS	게임물
GFRB	게임제공업
PBLICT	게재
WINTER	겨울
ARLSH	격납고
ENCRGM	격려
ISL	격리
ISLCTVT	격리재배
PRTWAL	격벽
BMNTH	격월
DSPRTY	격차
RELATE	견련
SMPINSP	견본검사
SMPLES	견본품
APRNTC	견습
TOWNG	견인
ESTMT	견적
PROVALE	견적가격
PRQUDO	견적서
PROINV	견적송장
RPRIMND	견책
RELSAMP	견품반출
LNBNS	견학
RSNDQF	결격사유
RESULT	결과
ABSENC	결근
CNCLSN	결론
RTJDG	결말판결
STRAP	결박
MSBR	결번
LNKTG	결부
STACNT	결산
CSCNN	결산금액
PSACNT	결산기
RTTCN	결산보고서
ABSNC	결석
DTJG	결석판결
FNVOT	결선투표
ORGZ	결성
DFCT	결손
DFMN	결손금
DCDS	결손처분
CRTLD	결약서
LCK	결여
FMHP	결연
VCANCY	결원
DECSN	결의
ANACT	결의서
SANCTN	결재
SANCTNER	결재권자
SANCTNER	결재자
DECSN	결정
DTNRM	결정규범
DICI	결정례
WRTDCS	결정서
DECSNFACTOR	결정요소
SETLE	결제
STPRC	결제가격
STQY	결제수량
STL	결제수수료
SETBANK	결제은행
SETLEDE	결제일
SETLER	결제자
TERPAY	결제조건
SETCUR	결제통화
CNCNTR	결집
CPTYWT	결탁소송
SHRTCOM	결함
BIND	결합
CTFS	결합범
CMBCTN	결합용기
TBERCL	결핵
TBCMNGBIZ	결핵관리업무
MRRG	결혼
MRNRY	결혼기념
HDADPT	겸보
SIDJOB	겸업
CBNTHB	겸영
CMBNAT	겸용
CBSP	겸용선
HDADPT	겸임
CTS	겸직
SPAN	경간
RDUCT	경감
BNDRY	경계
BNDRYLWST	경계소송
WARN	경고
ELAPSE	경과
TSLPRV	경과규정
ACCRDINTR	경과이자
TRNMEA	경과조치
SCENE	경관
GG	경기
GMCRR	경기경력
GRGZ	경기단체
GG	경기도
GAPYEONG	경기도가평군
GOYANG	경기도고양시
GWACHEON	경기도과천시
GWANGMYEONG	경기도광명시
GWANGJUSI	경기도광주시
GURI	경기도구리시
GUNPO	경기도군포시
GIMPO	경기도김포시
NAMYANGJU	경기도남양주시
DONGDUCHEON	경기도동두천시
BUCHEON	경기도부천시
SEONGNAM	경기도성남시
SUWON	경기도수원시
SIHEUNG	경기도시흥시
ANSAN	경기도안산시
ANSEONG	경기도안성시
ANYANG	경기도안양시
YANGJU	경기도양주시
YANGPYEONG	경기도양평군
YEOJU	경기도여주군
YEONCHEON	경기도연천군
OSAN	경기도오산시
YONGIN	경기도용인시
UIWANG	경기도의왕시
UIJEONGBU	경기도의정부시
ICHEON	경기도이천시
PAJU	경기도파주시
PYEONGTAEK	경기도평택시
POCHEON	경기도포천시
HANAM	경기도하남시
HWASEONG	경기도화성시
STDM	경기장
GGRR	경기지도경력
GN	경남
PRECNCT	경내지
MIRSTND	경대
LO	경도
LGHWGH	경량
CAREER	경력
CDP	경력관리
CPN	경력사칭
EXPM	경력자
CAREERDTA	경력자료
POCS	경력직공무원
CREVAL	경력평정
COURS	경로
CYCR	경륜
ACCNT	경리
FNCR	경리관
HRR	경마
RCTRCK	경마장
AUC	경매
DCCC	경매개시결정
GNTM	경매보증금
SBRPF	경매청약
PLAFS	경무
SLIGHT	경미
CNTRV	경범죄
MOA	경범죄처벌법
ALARM	경보
ALMSGN	경보기
EXPENS	경비
GURD	경비
GADBIZ	경비업
GUARD	경비원
ITSTY	경비지도사
SLT	경사
TARESCT	경사관세
INCLORBT	경사궤도
GRDNT	경사도
ICLLN	경사지
STN	경사터널
ORDNR	경상
WRKXPNS	경상경비
WRKXPNS	경상비
ORIN	경상이익
SINJPSN	경상자
ELC	경선
ELCPD	경선기간
ELCTR	경선선거인
ELDY	경선일
LCR	경수로
RENWAL	경신
CNTST	경연대회
MNGMT	경영
ADMINISTMNGMT	경영관리
BPL	경영방침
MNDG	경영위임
ADMINISTTRAN	경영이양
MNGER	경영자
ADMINISTGUDC	경영지도
STUATN	경우
CULTVT	경운기
CRCMSTNCS	경위
THRGH	경유
VIALOC	경유지
KURL	경의선
CLVT	경작
FMLND	경작지
CMPET	경쟁
CMPTPW	경쟁력
CTVD	경쟁매매
RVCMPN	경쟁사
CMPETRT	경쟁율
CPTSC	경쟁제한행위
HORN	경적
LHRNS	경전철
BTRC	경정
DCSCR	경정결정
RTRCC	경정등기
DISRECFN	경정처분
CLFOREC	경정청구
NOTFREC	경정통지서
ECNMY	경제
ECMNS	경제사범
EYFCY	경제성
EMCS	경제수역
FRNN	경제자유구역
PPDFEZ	경제자유구역개발계획
ENDR	경제적기본권
SPECOZN	경제특구
_OECD	경제협력개발기구
CTSNN	경조
SEEDLNG	경종
RCHOSE	경주마
FMLND	경지
CPTHB	경진대회
RSHFL	경질
PTDSCPL	경징계
LGHVHCL	경차
POLC	경찰
POLCFRC	경찰강제
POLCAGNCY	경찰기관
POLCEAUTH	경찰긴급권
POLCUNFM	경찰복
POLCSTTN	경찰서
POLICE	경찰청
CLBR	경축
FRFT	경품
CMPET	경합
TENDN	경향
EXPRNC	경험
ENMP	경협
GARD	경호
GDR	경호구역
SM	계
WRNG	계고
CLSS	계급
STAIRS	계단
EGSBS	계란집하업
MESUR	계량
MRNR	계량기
MTWND	계량기준
MESURUNIT	계량단위
MRNG	계류
CALC	계리
CMDMT	계명
ENLTN	계몽
ENLGH	계발
GNLGY	계보
CALC	계산
CALCPC	계산가격
BILL	계산서
LAIDUP	계선
CTNU	계속
CNNS	계속거래
CNSNC	계속보험
CNNTWR	계속비대형공사
CNSS	계속지역권
CFFCNT	계수
COUNTER	계수기
SCSN	계승
RVLS	계시
CNTRCT	계약
ENTY	계약금
CNTRCTAMOUNT	계약금액
CNTRCTPD	계약기간
CNBF	계약담당공무원
CNTRCTPRIC	계약대금
CRYMY	계약보증금
CTRTC	계약서
CNTRCTQY	계약수량
BRECONT	계약위반
PERBOND	계약이행보증
CNTRCTR	계약자
CRTRR	계약전력
CNTTK	계약직
MLLW	계엄
INTLTSH	계열
SERS	계열
ITRNR	계열기업
AFFLTS	계열사
SYSZ	계열화
AFFLTS	계열회사
CHFCLRK	계장
RELAY	계전기
SEASON	계절
SOCUSDY	계절관세
ACNT	계정
ACNTCTGR	계정과목
ACNTIEM	계정항목
ACNUT	계좌
ACNUTNO	계좌번호
ACNTR	계좌주
MSRINS	계측기
SCLSRT	계층
AHP	계층분석의사결정
DSCPLN	계호
PLAN	계획
TRFVPLAN	계획교통량
ACTPLN	계획서
HGH	고
HGHPC	고가
HIVALGOD	고가품
DRYUP	고갈
CSTMR	고객
CUSTRM	고객관계관리
CNS	고객니즈전략
CSTMRGRAD	고객등급
CSM	고객만족경영
CSNST	고객만족도조사
CMTT	고객민원
CUSANAY	고객분석
CSTMCMPL	고객불만
CTMMNY	고객사
CSTMRCNT	고객수
CSTMRINFO	고객정보
CMSWN	고객지주제
ARCHL	고고학
SRWGUD	고공품
ELTS	고과
HGSCHL	고교
HHSL	고교평준화
ANCPLC	고궁
HGHNK	고급
ANCMT	고기후
ALPAR	고냉지
ALPAR	고냉지대
ANCHST	고대사
ANTCTY	고도
ACYSRBUS	고도보존사업
ADVANC	고도화
HHRDC	고등교육
HLLFY	고등교육기관
HCRTJT	고등법원
HGSCHL	고등학교
HGSCHST	고등학생
WHALE	고래
ALPAR	고랭지
CNSDR	고려
CDRPR	고려기간
ADNGE	고령
AGSCEY	고령사회
AGED	고령자
AGING	고령화
AGSCEY	고령화사회
HTSBL	고리금지법
HHRS	고리대
RUBBER	고무
ANRDVC	고박장치
ACCS	고발
HHLDD	고부가가치
MCRMLCL	고분자
PLMMTR	고분자재료
HLLRPD	고분자화합물
WTHR	고사
ALP	고산
WLLR	고살
ANTBK	고서
HITARAT	고세율
CMPLNT	고소
PHRFC	고소권자
ACCSR	고소인
STHN	고소추완
CCLP	고소취소
HGHSPD	고속
HHDGW	고속국도
FRWY	고속도로
EXPBUS	고속버스
HHDH	고속선
HDSHP	고속여객선
HSDL	고속철도
HPRYV	고속철도차량
CTDTK	고속회선교환망
HGY	고수익
NTFC	고시
OCLC	고시금액
ORPHAN	고아
DSIGN	고안
HHPSR	고압
HGVLT	고압
HPSRG	고압가스설비
HPRSRK	고압작업
LGMT	고액
HGHF	고열
AGTORN	고엽제
EMPLYM	고용
EMPLYMINSRNC	고용보험
EMPLY	고용인
EMPER	고용주
POLS	고용직공무원
HRN	고위
ESNTL	고유
PCLRT	고유권
INNB	고유번호
LSDSNT	고유법
INRPR	고유재산
DEFECT	고장
DTQRY	고장신고
DEFECTCAUSE	고장원인
DCTYP	고장유형
DFTK	고장작업
DTRPT	고장접수
HGVLT	고전압
HHRPMR	고점성물질
FIXING	고정
FIXVALE	고정가격
FDPY	고정급
FDST	고정자산
FXCYT	고정직접지불금
FIXINGLD	고정하중
FERS	고정환율제도
HGHD	고조
HHRQC	고주파
HRCRH	고증
NTIC	고지
HLLSCT	고지대
NHT	고지서
DYFNC	고지의무
STELSCP	고철
STSCARA	고철장
SCRPG	고철화
SOLID	고체
SLCL	고체화학물질
DSTRSS	고충
DFLYCP	고충민원
GCRNZ	고충처리기관
ENCRMN	고취
UPLAE	고층
UPASP	고층대기
PAIN	고통
HGHLT	고품질
HMTWN	고향
HHPRS	고혈압
SOLDRFY	고형화
SDDTY	고형화처리설비
CRLS	곡류
CURV	곡률
CRLS	곡물
CURVE	곡선
CRLS	곡식
AWRDPS	곤경
GNDL	곤돌라
DFFCLTY	곤란
STICK	곤봉
INSECT	곤충
ISFNCS	곤충동물매개감염병
ITNFNW	곤충동물매개감염병고위험작업
CURIOS	골동품
ALLEY	골목길
PSHR	골반충격부위
AGGRGT	골재
AGRSINS	골재자원조사
AGPKBS	골재채취업
FRAC	골절
GOLF	골프
GLFPR	골프연습장
GLCRS	골프장
MOLD	곰팡이
MLTPLC	곱셈
ETY	공
SPCE	공간
MNCE	공갈
OTHBC	공개
OPNBDNG	공개입찰
PBLKY	공개키
ATTACK	공격
PBLANC	공고
WRTANC	공고문
PBLANCDE	공고일
PUBLIC	공공
PBLBLD	공공건물
PBUE	공공건물공중이용시설
PADMINST	공공관리주체
PBLTEQP	공공교통시설
PBLINSTT	공공기관
PBLTCH	공공기술
PBLCORP	공공기업
PBLCORP	공공기업체
PBLGRP	공공단체
IBLLBR	공공도서관
PHMT	공공보건의료
PHMINSTT	공공보건의료기관
PBLSCT	공공부문
PBLASST	공공부조
PSER	공공비축미곡
PBLWTRS	공공수역
PBLFCLT	공공시설
PBCRSINST	공공연구기관
PBLFCLT	공공용물
WRCPCS	공공용수면
LNDPUS	공공용지
PBLDCRM	공공위험죄
PBLINFO	공공정보
PBLASCT	공공조합
PBLOAN	공공차관
PBCLNAGR	공공차관협약
PBLSRV	공공측량
PBLSWRG	공공하수도
PBLSWINTD	공공하수도관리청
PBLDUS	공과금
EMBLGBD	공관
EPCLN	공관로
PBLEDC	공교육
TOOL	공구
ARFRC	공군
GNTRT	공권
PBLPWR	공권력
PBLMNY	공금
SUPLY	공급
SPLPC	공급가
SPLPC	공급가격
SPLPIP	공급관
SUPLER	공급사
SLYB	공급사업
SLYP	공급설비
SPFL	공급시설
SUPLER	공급자
AIR	공기
ACEIBT	공기매개감염병
PBLCORP	공기업
PEPRVLG	공기업특권
LSLCS	공기업특허
ASDFLT	공기정화설비
AIRGUN	공기총
ISRLPX	공단
PBLCRP	공단
COPERTN	공동
UTLPPCNDT	공동구
JTSC	공동구조
JTRY	공동담보
JTNC	공동대리
JMLTY	공동면책
JNWB	공동발행인
JNDRS	공동배서인
COPSHOP	공동배선
JNTPRT	공동배선사
JOBOARA	공동보세구역
JNST	공동보증
JNRC	공동보험
JNNTC	공동상속
JLTG	공동소송
CFCTAX	공동시설세
JNTS	공동압류
CPRTT	공동연구기관
WORKSHP	공동연수
COPERTNRELTE	공동유대
JCT	공동인수인
JMTG	공동저당
JPS	공동점유
JRFND	공동정범
APHUS	공동주택
JTNR	공동지배인
CRCLT	공동집배송센터
JTBT	공동채무자
JNDY	공동친권
JTDNT	공동피고인
GRRG	공동해손
BLNK	공란
DSPLAY	공람
EXPLT	공로
MERITER	공로자
BNSTK	공로주
PBLINST	공립
PBLSKL	공립학교
PBLSAL	공매
POTPA	공매대금
SRTSKSEL	공매도
WOTPA	공매보류
PPTPA	공매예정가격
TOTPA	공매조건
CLNELE	공명선거
PSSRP	공모
PSSRPC	공모가
PSSRPC	공모가격
PSCPAMT	공모금액
POFSTK	공모주
AFTPSB	공모후
OFCS	공무
RTKCR	공무담임권
GFC	공무소
PBSVNT	공무원
OSCTFD	공무집행방해죄
OFLDC	공문서
GRNRT	공물
PPRPLCE	공물경찰
PPMA	공물관리권
GYPRS	공물사용권특허
SHOP	공방
COMPLC	공범
MSRC	공법
MYGNR	공병
OCPR	공보
BPRM	공보처
STUDY	공부
SDYRUM	공부방
CNTRWK	공사
CWKV	공사감리
CSCRNR	공사관리지역
WRKMM	공사명령
CCSNT	공사실적액
CWRKB	공사업
CSRKMN	공사업자
CRR	공사이행보증서
CNSTRCTR	공사자
CNSTRST	공사장
PBNCD	공사채
IDTC	공산품
INSCMR	공상
SCNCDS	공상군경
PBLC	공설
ARGNM	공소
ATTSTS	공소권
PIPP	공소불가분원칙
FSRGD	공소사실
PSPPS	공소시효
INDCTMNT	공소장
FYTT	공수비행
PBLNTF	공시
POTVALE	공시가격
SVBTC	공시송달
OLNLP	공시지가
OFCL	공식
ETYRM	공실
PBLSCR	공안
ARPRSCY	공압실린더
PPLDG	공약
INDSTRY	공업
INDPRP	공업용
INDTWTR	공업용수도
IDSWTBIZ	공업용수도사업
ISMN	공업용수도사업자
IDTRR	공업지역
GRANT	공여
GNTR	공여구역
GCRW	공여해제반환재산
AIRSPC	공역
PBLPRFR	공연
PPRRT	공연권
COSTR	공연자
PRFPLC	공연장
PBLPSS	공연점유
PBLMNG	공영
PBLGRG	공영차고지
IDSRS	공예
APLDRT	공예품
CMNUSE	공용
OCBNC	공용개시
PBLGUD	공용물
PBLOD	공용부담
OFCBST	공용부분
OFCLINVE	공용송장
CYPRP	공용수용
CSWEPN	공용화기
OFCDSW	공용환권
RLTBL	공용환지
PARK	공원
PRKPLAN	공원계획
PRKDSTR	공원구역
PRKBSPN	공원기본계획
PRKGRNLND	공원녹지
PRKPTAR	공원보호구역
PRKBIZ	공원사업
PRKFCLTY	공원시설
CNRS	공유
PBLONSIP	공유
LNSH	공유기
PONFRS	공유림
COWNPR	공유물
COWNPRPT	공유물분할
PBCWTRS	공유수면
COCNR	공유자
PBPRT	공유재산
PUBLND	공유지
PONSHLND	공유토지
PBLBNF	공익
PINTRRT	공익권
PPIS	공익근무요원
PGLOFCER	공익법무관
PBLCRPR	공익법인
PBCBIZ	공익사업
PBIZDSTR	공익사업시행지구
PBLSVC	공익서비스
CPLR	공익채권
ATHRI	공인
CDLBN	공인노무사
OGTWR	공인인증기관
OGCR	공인인증서
OFCTF	공인인증업무
OGDCT	공인전자문서보관소
OCGNT	공인전자서명
LREA	공인중개사
_CPA	공인회계사
MCHL	공작기계
ATCN	공작물
FCTRY	공장
EXPRICE	공장도가격
FRTBL	공장설립
FTYSL	공장신설
EXW	공장인도조건
FCTRYFNDT	공장재단
FCTRYMRTG	공장저당
FRNC	공장증설
PBLEN	공적
_ODA	공적개발원조
PBLASTN	공적부조
DEAFREG	공적운임
PBLFUND	공적자금
ARCBTBL	공전법규안
FAIR	공정
PROCS	공정
FTC	공정거래위원회
AWSTNR	공정규격
OCXRS	공정금리
NRLD	공정증서
DDC	공제
DETVALE	공제가격
DDCAMOUNT	공제금액
BDMETH	공제법
COPR	공조
OGNRM	공조범죄
MSTTR	공조조약
PBLIC	공중
PBLHBIZ	공중보건업무
PBLHDC	공중보건의사
ANTN	공중선
ATNSYS	공중선계
ATNGN	공중선이득
ATELPW	공중선전력
PUBSNT	공중위생
PLHBIZ	공중위생영업
PBLFCLTY	공중이용시설
PBLTEL	공중전화
PBLTELP	공중전화기
PBCTLT	공중화장실
NTRAT	공증
ANCC	공증문서
NTRAT	공증행위
NOTICE	공지
BLTN	공지게시판
NOTICE	공지사항
NTBD	공지사항게시판
NTICER	공지자
PBLDTY	공직
POFCELC	공직선거
POELPD	공직선거기간
POELPCDD	공직선거예비후보자
POFELCDD	공직선거후보자
PBLOFCL	공직자
CDBFL	공직후보자
EMPTVHCL	공차
ONTPM	공채
PBLHR	공청회
LDGMNT	공탁
CMMN	공통
CMNRM	공통서식
CHGL	공통선신호방식
CMMNLDADNGCMPRT	공통적재구획실
CNSRN	공통필수기구
TRIAL	공판
TIADE	공판기일
JMRKT	공판장
TIACRT	공판정
TRLPRTC	공판조서
EQUITY	공평
PRMLGT	공포
PRMGDE	공포일
BLKCTR	공포탄
PUBLICT	공표
ENGNER	공학
ARPRT	공항
APHR	공항만
ABMOTG	공항만감시
ARTSTPC	공항상주업체
ARPRTOPRTR	공항운영자
POLUTN	공해
CNTRB	공헌
NLDN	공회전
MRIT	공훈
HLDY	공휴
HLDY	공휴일
KWA	과
PAST	과거
PYMTEXC	과납
PSTYR	과년도
DBPFY	과년도지출
EXCSS	과다
ERTS	과대광고
OVRPAK	과대포장
FRTNF	과도
OVRWK	과로
MNOFNE	과료
SBJECT	과목
OVPOP	과밀
OVPALOT	과밀부담금
OVPRSAR	과밀억제지역
MJRTY	과반수
OVSHRTS	과부족
CIORC	과부족사고화물
MOLC	과부족용인조건
OVLOD	과부하
TAXT	과세
CVODV	과세가격
PEFODV	과세가격사전심사서
TAXAMT	과세금액
TAXPD	과세기간
TAXATHR	과세당국
DUTGODS	과세물건
REVATAX	과세보류
TAXYY	과세연도
REQTAX	과세요건
MRLX	과세자료
TPJS	과세적부심사제도
PRETAX	과세전
PETAXNTE	과세전통지
INFTAX	과세정보
GSTTAX	과세통관대상물품
STDTAX	과세표준
SNDDS	과세표준수정신고서
SNDSC	과세표준신고
SRDSST	과세표준신고서
FERTAX	과세환율
LTTLN	과소
OVRSPD	과속
FTR	과수
ORCHRD	과수원
FAULT	과실
CTVLN	과실상계
NLNCS	과실점유
PLWF	과실책임주의
FALT	과오
OVERRPAY	과오납
OVERRPAY	과오납금
ERRRR	과외교습
ORCHARD	과원
ELFF	과잉방위
DRHF	과장
OVCHRG	과적
OCVHCL	과적차량
OLGP	과점
CRSE	과정
TASK	과제
TKCRD	과제카드
SURCHRG	과징
SRCHRG	과징금
FIEDEF	과태
MGNC	과태금
FFNLG	과태료
STDTAX	과표
SNFX	과표금액
SCNCE	과학
HTSEQUP	과학검색장비
SCNMSM	과학관
SCNTCHR	과학교원
SCNEDUC	과학교육
SCNEDORG	과학교육기관
TKNEDPGM	과학기술교육프로그램
TIBFB	과학기술국제화기반조성사업
TCNITNBIZ	과학기술국제화사업
STECPEX	과학기술단지
MOST	과학기술부
TFGDRI	과학기술분야정부출연연구기관
TKNDATA	과학기술자료
PUISH	과형
KWAN	관
IRG	관개
RELATE	관계
CRDNS	관계기관
RCPY	관계기업
REV	관계레벨
RLW	관계법률
RLQP	관계시설
PARTCPNT	관계인
PARTCPNT	관계자
SDTT	관계중앙행정기관
STSDR	관계중앙행정기관장
RLR	관계지역
REL	관계코드
PBLOFC	관공서
TURSM	관광
TURIST	관광객
SSY	관광단지
TRINDSRY	관광사업
TRSAGNT	관광사업자
TRSMIC	관광안내소
TRRSRT	관광지
STSR	관광특구
GVSL	관급
MSPLHN	관급재료
ALBTR	관급품
WHTHRC	관내
VIEWNG	관람
ADTM	관람석
RELATE	관련
RELGOAG	관련기관
CNCKR	관련복지제도
RDND	관련산업
RLTPSN	관련자
PLINE	관로
MANAGE	관리
MNGTK	관리과제
MC	관리국
MNRT	관리권
MNGR	관리권자
MGC	관리기관
MANAGETRGET	관리대상
FRRMN	관리대상수산자원
HLFMG	관리대상유해물질
ITMCOLD	관리대상화물
MNDBN	관리방조제
MGND	관리부대장
MANAGECT	관리비
MGBS	관리업
MNGR	관리자
VADSTCR	관리자카드
MANGE	관리주체
MGSHR	관리처분권
INTNDNC	관리청
MBX	관리함
SRB	관목
GTW	관문
GVNGD	관물
OFCTT	관보
VWTR	관상
VWARN	관상용
GRFC	관서
CSTMS	관세
CEDID	관세EDI환급시스템
CSTMSPOLICE	관세경찰
EFTS	관세계좌이체납부제도
CUSTOMB	관세고충처리담당관
CUSTPRC	관세관행
CUSTUON	관세동맹
CUSTOFDR	관세범
CUSTACT	관세법
STPETAX	관세부과제척기간
CSTBRKR	관세사
LCBACT	관세사법
CUSTBRG	관세사수수료
TRFEQU	관세상당액
CUSTLNE	관세선
CUSTREV	관세수입
CUAPCTE	관세심사위원회
CUDECTE	관세심의위원회
CDUAMT	관세액
TAFCOSN	관세양허
CMRTR	관세영역
CUSTGOL	관세용어
TARRATE	관세율
TARSCHD	관세율표
TRQ	관세율할당
INCDTAF	관세의귀착
EFPRATF	관세의실효보호율
FRZN	관세자유지역
TAFBARS	관세장벽
IOCD	관세조사
CNCULAB	관세중앙분석소
NOFZARA	관세지역
COLCUST	관세징수
RTCDUT	관세징수권
EPRC	관세징수권소멸시효
PCU	관세징수의우선
CUSTOMS	관세청
CUELMBX	관세청사서함
CMSNER	관세청장
CCCNTR	관세청종합상담센터
CKM	관세청지식관리시스템
CDW	관세청통합정보시스템
APCUSDY	관세충당
CUSROTE	관세통로
TAVATAT	관세평가
CMCUREW	관세포상심사위원회
EVCSTDY	관세포탈
CRTFEV	관세포탈죄
TFCLCTE	관세품목분류위원회
TFQUASYS	관세할당제도
ANICADM	관세행정사전안내
CCC	관세협력이사회
CCCN	관세협력이사회상품분류표
CPEN	관세형벌
TARFFICN	관세화
CUSDRBK	관세환급
CUSDRSYS	관세환급시스템
DRASELT	관세환급심사선별기준
MCOCD	관세환급업체관리
RTCCD	관세환급청구권
KP	관수
CUSTOM	관습
INTRST	관심
PPS	관압
OFFL	관용
OFSPT	관용여권
GVNGD	관유물
GRPTY	관유재산
OCSL	관인
CHARGE	관장
TRSTEE	관재인
ARTHR	관절염
VIEWPOINT	관점
CNTRL	관제
ARTCNT	관제사
CTRNTR	관제소
CTRLR	관제자
OBSERV	관찰
ORMTL	관찰물질
OBSRVR	관찰자
GRC	관청
OBSR	관측
IS	관측강도
WETHERPENO	관측기상현상
DIR	관측방향
OBSRVT	관측소
OBTIME	관측시간
KMAMDOV	관측시정
GVCL	관학
CMPTNC	관할
JHLC	관할경찰서장
CMPTOFC	관할관청
JURANG	관할구역
JRSDC	관할권
CMPTINST	관할기관
JDCMD	관할부대장
JRDTT	관할선거구위원회
MANCTM	관할세관
JURCC	관할세관장
VJDC	관할위반
BROFC	관할지청
JSDSR	관할해역
CSRRC	관행
FCOC	관혼상제
PARNTHS	괄호
OCMBR	광ADSL
OCDM	광DSLAM
FLC	광가입자전송장치
ADVRTS	광고
ADVERT	광고물
ADVGODS	광고용품
OCLR	광단국
BRDSM	광대역시스템
BBNTN	광대역안테나
BBCNW	광대역통합망
BTSDW	광대역통합연구개발망
BTRCR	광대역통합정보통신기반
BDRSTW	광대역통합정보통신망
MNRL	광물
WDSCP	광범위
OFTR	광분배함
MINE	광산
MWKR	광산근로자
MNTY	광산보안
MNMG	광산피해
FIBER	광선로
MNIDST	광업
MINRGT	광업권
MNRTER	광업권자
MNLW	광업법
MQP	광업시설
WDR	광역
WDFFC	광역교통시설
WCTLN	광역도시계획
WRTS	광역상수도
WDRPL	광역상수원
BRVC	광역서비스
BCITY	광역시
BRTC	광역시도
WRQ	광역시설
WRCRL	광역전철
SOT	광원
SQARE	광장
OTTS	광전송
GJ	광주
GJ	광주광역시
GWANGSAN	광주광역시광산구
GJNAMGU.KR	광주광역시남구
GJDONGU.KR	광주광역시동구
GJBUKGGU.KR	광주광역시북구
GJSEOGGU.KR	광주광역시서구
OTRPTR	광중계기
MNLSPT	광천지
OTLBL	광케이블
MNDMG	광해
MMRN	광해방지사업
MDMM	광해방지사업자
MNSLS	광해방지의무자
CFDTS	광해배상
GWNGWHMN	광화문
PHTCHM	광화학
PIER	교각
COURSE	교과
CRCLM	교과과정
COURSE	교과목
TXTBK	교과서
TXTBOOK	교과용도서
DRLMST	교관
TCHAID	교구
TCHATHR	교권
SKLGRND	교내
SHIFT	교대
MRFM	교도
PRSOFCR	교도관
PRISON	교도소
PRSLBR	교도작업
DSTRB	교란
BRIDGE	교량
EXCHG	교류
ALTRCRT	교류
TRE	교목
SKLAFS	교무
DELVRY	교부
GNNY	교부금
DTRFEE	교부세
DVYC	교부송달
ABTNT	교사
TCHER	교사
ABTR	교사범
NGT	교섭
NTPRT	교섭단체
PROFSR	교수
FTMMR	교수요원
TNINSTT	교습소
CLSSRM	교실
TCHPGM	교안
CLTR	교양
TRADE	교역
RVISN	교열
ETRMT	교외교육
TCHER	교원
EDC	교육
ECRDR	교육경력연수
ECSPL	교육공무원
MEST	교육과학기술부
ECLST	교육기관
EDCCT	교육비
STDNT	교육생
ECX	교육세
ESHNS	교육연구기관
EDCL	교육용
MOE	교육인적자원부
TCHER	교육자
EDUSPNTD	교육장
EFSRC	교육정보제공체제
OFCDC	교육청
EDADM	교육행정
EDSGN	교육행정기관
SCHULMSTR	교장
DLN	교장
TCHMTR	교재
BLGRN	교전상태
CRRC	교정
CRRCT	교정
CCS	교정법인
CRWRK	교정업무
RFDS	교정처분
SKLSTE	교지
TCHPFS	교직
TCHTRNCRS	교직과정
SKLSTF	교직원
CRS	교차
CRSRD	교차로
CRSRSPNSBL	교차책임
CSFR	교차청약
CRSPASSWAY	교차통로
EXCHNG	교체
RLIEF	교체자
SCHRGL	교칙
TRNSPORT	교통
MSFTSR	교통기관
VMTC	교통량
TFCNWK	교통망
OSCR	교통방해죄
TFCACD	교통사고
TFCBIZER	교통사업자
TFCILND	교통섬
TRANTAX	교통세
TFCMN	교통수단
TFCDMDMNG	교통수요관리
TFCEQP	교통시설
TFCSFFC	교통안전시설
TFCWKER	교통약자
TFCBIZENER	교통업무종사원
CSDWTF	교통유발부담금
TFCSVY	교통조사
TFCSYS	교통체계
TFCSYSMNG	교통체계관리
TFCMN	교통편
TFCADMORG	교통행정기관
OVRSEKRNS	교포
TCHEDU	교학
EDFC	교화
EXCHNG	교환
EXTIKET	교환권
ETSWYM	교환기
ENCT	교환설비
CLRNG	교환액
EXECDC	교환전자문서
PPLCORT	교황청
CHURCH	교회
SZTB	교흉고
GU	구
OLD	구
NI	구
SCTN	구간
ORCVT	구강
DTLTB	구강보건사업
ORLCS	구강보건용품
CALBR	구경
GU GUN	구군
CNFNM	구금
DSDCL	구금보호시설
RELIF	구급
AMBLNC	구급차
RESCU	구난
PREMIS	구내
IDLS	구내배전설비
IDPS	구내외
YRDTRNS	구내운전
PCLF	구내통신선로설비
READER	구독자
MTHWRD	구두
ORDESYS	구두신고제
PNLDTENT	구류
CLOUD	구름
COPPR	구리
PURCHS	구매
PURCHSRT	구매권
BUYAGNT	구매대리인
PURCHSHT	구매서
PURCHSR	구매자
BUYLOG	구매자관리대장
PURCORD	구매주문서
PURCHSOFC	구매처
PURLIMT	구매한도액
RESC	구명
SE	구분
DIV	구분내용
RGSTPRT	구분등기
PRTOWN	구분소유
DDWP	구분소유권
PRTOWNER	구분소유자
SPRTR	구분자
PRTSPRF	구분지상권
POSES	구비
INDMRT	구상권
COMTRAE	구상무역
COMPOSITION	구성
CMPNTRT	구성비
CONSTNT	구성원
SALV	구세
DETON	구속
ARSTT	구속영장
ZONE	구역
ZNINDSTR	구역업종
DLCRJ	구역전기사업
DTCTR	구역전기사업자
WRDMNG	구영
GULND	구유지
GPMN	구읍면
JO	구인
PURCHS	구입
PCSPRT	구입부품
PCSMTR	구입재료
CLDINDT	구입처지정구매위탁
WRDOM	구전
RLIF	구제
STRCT	구조
RESCUE	구조
STLC	구조내력
RSCUNT	구조대
STRCTU	구조물
STRCTR	구조체
EUROPE	구주
JBHNT	구직
WRDOFC	구청
DSTLDR	구청장
CNCRTNS	구체
CNSTC	구축
DTNHS	구치소
BEAT	구타
EMBD	구현
ODSYL	구형
SPHSHP	구형
ALMS	구호금품
CMPRT	구획
YEAST	국
BURA	국
NATION	국가
CTYLN	국가계획
BDLP	국가균형발전
CTCT	국가기간교통망
CTRRC	국가기간교통시설
NAK	국가기록원
CYSYM	국가기반체계
CRLLQC	국가기술자격
CRYKFR	국가기술자격등급
CSLLM	국가기술자격종목
CYKCDM	국가기술자격직무분야
NLTHT	국가대표선수
NLSQ	국가방위요소
SCNS	국가배상
STTC	국가보상
NHWMST	국가보훈관계법령
NTTTN	국가보훈대상자
PVAA	국가보훈처
NATIONALOTM	국가부담금
NSC	국가안전보장회의
CTLF	국가자격
CQFNR	국가자격관리자
NIS	국가정보원
CTFMD	국가정보자료
CMCQ	국가중요시설
CRNYSM	국가지리정보체계
CTYNRD	국가측정표준
CYTD	국가표준
CSPNP	국가필수국제선박
BODE	국경
DELAFNR	국경인도가격
VPAB	국경출입차량
VNRB	국경하천운항선박
NTNTRS	국고
RENATRE	국고귀속
NLFS	국고금
GOVSUBY	국고보조금
NTPBND	국고채
NLLP	국공유재산
NTPBND	국공채
NLG	국기
DMSTC	국내
DWHOCE	국내도매가격
DMSTCBNRPCPROCSS	국내도산절차
DSKT	국내반입이식
DMSTCSCRTYINFO	국내보안정보
ITNCS	국내사업장
HBRD	국내외
ITNF	국내이송
DEDVALE	국내판매가격
NLRD	국도
NATN	국립
NLPRK	국립공원
NFQIS	국립수산물품질검사원
RRA	국립전파연구원
STMNST	국무위원
OPC	국무조정실
PRMNST	국무총리
OPM	국무총리비서실
KOREAN	국문
MRFN	국민
PHPB	국민건강증진사업
NEAC	국민경제자문회의
OMBUDSMAN	국민고충처리위원회
GNPSC	국민기초생활보장제도
NPN	국민연금
NPNRR	국민연금관리공단
NNYM	국민연금제
NRH	국민임대주택
NLLX	국민임대주택단지
NHBD	국민주택채권
NTLRFD	국민투표
OCM	국민훈장
NFS	국방
NDLRYS	국방군사시설
NDNLTS	국방군사시설사업
MND	국방부
KDD	국방일보
TELOFCNO	국번
NXNDR	국비
NRCTD	국비연수
SDGPS	국비유학
NXDT	국비환자
KHIST	국사
SDWLGO	국산품매장
OUTWR	국선
CPDW	국선변호인
OWCE	국선접속설비
NLT	국세
THLNT	국세기본법
PUB	국세발간
NTAXTRB	국세심판원
NTCL	국세징수법
NTS	국세청
ANTXRFD	국세환급금
INST	국세훈령
KTPA	국악원
KRLGG	국어
LGTY	국어능력
NPR	국영
STATRDE	국영무역
OUTNATN	국외
RPOAIE	국외반출입규제대상생물
OSCRM	국외범
ONTIA	국외부실자산
OCTRN	국외이송
ONTNIF	국외정보
FNTDR	국외지배주주
GRRSP	국유
NLST	국유림
NFRMNG	국유림경영
NTNRMNG	국유림관리
NPRTY	국유재산
GOLND	국유지
GNRGT	국유품종보호권
OFRTR	국장
NLTY	국적
NTNADM	국정
IPFTM	국정감사
NATARF	국정관세
ALLIM	국정홍보처
INTRL	국제
_IDA	국제개발협회
ITNLD	국제거래
ITJRH	국제공동연구사업
IVTS	국제공무원
INTRLREGLGDS	국제규제물자
ILN	국제기구
ITRLD	국제기금
ITLFR	국제기금협약
INTRLSTDR	국제기준
SMNRN	국제단위계
INTRLROADTRNSPRT	국제도로운송
ITPB	국제도로운송증서
ILLNG	국제도산관리인
INCB	국제마약통제위원회
INCTRM	국제무역규칙
HUBINTE	국제무역의중심지
INCBTRS	국제복합운송
_IBRD	국제부흥개발은행
INLHM	국제사찰
INTRLSHIP	국제선박
INTRLCNVCTTRNSF	국제수형자이송
_UN	국제연합
_UNESCO	국제연합교육과학문화기구
INTRLBID	국제입찰
FTRCTY	국제자유도시
INTRNL	국제적
INTAXCOM	국제조세경쟁
INTRLMESURESTD	국제측정표준
INTTK	국제통화
_EMS	국제특급우편
ITNPSR	국제특별해역
INTRLSTD	국제표준
_ISO	국제표준화기구
IATA	국제항공운송협회
INLL	국제항해
_IMO	국제해사기구
INTRLEVENT	국제행사
PIIE	국제행사참가자
INTCPBIZ	국제협력업무
INCPR	국제협력요원
ITRCTR	국제협력의사
INTRNLZ	국제화
INNPLNDTR	국제화계획지구
ITRLC	국제회의
CNSLD	국제회의도시
IRCT	국제회의산업
IFNSN	국제회의산업육성기반
ICRCCY	국제회의시설
ITNRR	국제회의전담조직
NTNDBT	국채
NTPLPJ	국책사업
TRIT	국토
ASSEMBLY	국회
ARMY	군
SPBP	군납품
ARMY	군대
CYPK	군립공원
SSN	군번
MRCFR	군법무관
MSCL	군별
MTFR	군복
MILTR	군부
ARMMNT	군비
MRYFR	군사
MLSTS	군사기밀
MTYTN	군사기밀공개
MRFX	군사기밀제공설명
MTYS	군사시설
ASRTR	군사시설보호구역
CTAX	군세
MTSPL	군수
NTLP	군수용마약류
WRPL	군수품
WLN	군용기
MTYSS	군용선
MLTGR	군용장구
MRLHDN	군위탁생
GUNLND	군유지
ARMYINTRRGTV	군의문사
SOLDER	군인
ARMOR	군장
MYCRS	군장학생
ARMKD	군종
AMYFNT	군첩보부대
CNTHBL	군청
DSARM	군축
NVLR	군항
WNDNG	굴곡
CHMNY	굴뚝
EXCVTR	굴삭기
RFRCT	굴절
DGG	굴착
PALACE	궁
ACHSTE	궁도장
RYCRT	궁중
VLM	권
TRPPS	권계면
RCMND	권고
RCMBIL	권고안
RIGHT	권리
RMNRM	권리관리정보
PREMUM	권리금
ETSFT	권리설정
RGHPSN	권리자
PTNSTK	권리주
PLDGRT	권리질
ACQRGH	권리취득
WNH	권양기
DSTRCT	권역
CNVS	권유
CNVSR	권유자
INTRRT	권익
RECMND	권장
BNDUNT	권종
AUTHOR	권한
AUTHORY	권한자
ABSEN	궐석
VCANCY	궐위
GTRK	궤간
TRACK	궤도
TRCWHL	궤적
HMCM	귀가
PRGN	귀감
HMCMG	귀국
PCUMTL	귀금속
VIP	귀빈
VPRM	귀빈실
RTTSH	귀선
HMG	귀소
RVERS	귀속
RRP	귀속시설
DEFCTN	귀순
IMPT	귀책
CSBBL	귀책사유
NTRLZ	귀화
RETN	귀환
RLSBEP	귀휴
STNDRD	규격
SNLRC	규격전력
SRCEXM	규명
SCALE	규모
NORM	규범
CVNNT	규약
REGLTNS	규율
REGLTN	규정
REGL	규제
CITES	규제대상품목
RGRFT	규제병해충
RLFC	규제영향분석
RLCP	규제특례
RULE	규칙
GERM	균
EQLTY	균등
ELDNC	균분상속
CRCK	균열
FLAT	균일
BALNC	균형
BSC	균형성과평가제도
SWNG	그네
SADE	그늘
GRAPH	그래프
GROUP	그룹
GROUPBY	그룹별
GRPWR	그룹웨어
GRID	그리드
GBELT	그린벨트
PICTR	그림
POLE	극
PLORB	극궤도
PLOBST	극궤도위성
SBJGAT	극복
POLAR	극성
THEAT	극장
PLRRGN	극지
MCRWV	극초단파
MCRWVBAND	극초단파대역
RSMNG	극한작업로봇
BASIS	근거
MCTMD	근골격계질환
MDAGE	근대
MDRSY	근대사
LABOR	근로
LABORCNTRCT	근로계약
ERNM	근로소득
_EITC	근로소득보전세제
ECMT	근로소득세
LABRR	근로자
SLWB	근로자공급사업
WRLT	근로자대표
WKPH	근로자파견
WRTHNT	근로자파견계약
WRPTBS	근로자파견사업
LABORCND	근로조건
NGHBRHD	근린
DLGNC	근면
WORK	근무
WRKR	근무자
WORK	근무작업
WRKPLC	근무처
CNWK	근속
SRC	근원
MUSCL	근육
FDLTR	근저당
NRIFRCHN	근적외채널
ERDC	근절
LSATT	근청
NRTVR	근친혼
DCLZ	근태
SNTNC	글
FONT	글꼴
GLOBAL	글로벌
WRTER	글쓴이
FONT	글자체
GLD	금
FNCSUSV	금감원
KFTCIN	금결원
FORB	금계
SVNBDY	금고
TABOO	금기
THSYR	금년
INRST	금리
INTRTFTR	금리선물
METAL	금속
METAL	금속류
CTBDS	금수품
AMOUNT	금액
PRHSMK	금연
FRI	금요일
THSMON	금월
FNNC	금융
FVSTT	금융감독기관
FNCSUSV	금융감독원
FSC	금융감독위원회
FNCDL	금융거래
IVFNTRD	금융거래조사
FNNCSETLE	금융결제
KFTCIN	금융결제원
FNRT	금융관련법령
FNLT	금융기관
BRBS	금융보험업
FNCBIZ	금융업
FCDM	금융자금대출금
BPT	금융자산
FIU	금융정보분석기구
FNDPY	금융지주회사
TODAY	금일
CRRNCY	금전
MRYMP	금전배상
MTRCLN	금전채권
THSWIK	금주
PRHIBT	금지
PBHRMMT	금지유해물질
INCPT	금치산
IPNSN	금치산자
PRHIBT	금칙
GTOIS	금탑산업훈장
MNGD	금품
MLD	금형
AFTTHS	금후
RDDC	급감
SDNCHN	급변
BNFT	급부
IMPBPR	급부불능
ACFDSES	급성
WSP	급수
GRAD	급수
WTRPL	급수장
WSST	급수장치
MLSV	급식
MSNS	급식경비
MLC	급식학교
FCTH	급양
SALARY	급여
REFUEL	급유
FEEDER	급전선
SDNINCS	급증
EXPSS	급행
POSTV	긍정
GIGA	기가
DSMSSL	기각
PD	기간
WNRD	기간내
OLSLN	기강
MCHN	기계
MCHNE	기계식
MHNKT	기계식주차장
MCHNEPARKNGDEVICE	기계식주차장치
MCVB	기계식주차장치보수업
CNRB	기고
INSTT	기관
ENGN	기관
ITNMR	기관번호
EHSCT	기관별지휘소
ISTFM	기관서식
ITRLST	기관인사관리시스템
ISTDR	기관장
ISTSTM	기관평가
ORGNZ	기구
UTNSIL	기구
PRABVT	기권방지
ENDW	기금
FCSVY	기금관리위원회
MHRLS	기기
INFLGT	기내
CMMR	기념
MUMT	기념비
ANNVRSRY	기념일
SVENR	기념품
SKLL	기능
FNCT	기능
FCMT	기능경기대회
PLTCHCOLG	기능대학
FNCTL	기능별
BRMF	기능별분류체계
BRML	기능분류체계
FNCLTY	기능성
FCSS	기능성화장품
FNTP	기능유형
VHC	기능인
CFHC	기능장
FP	기능점수
TCNSRV	기능직
EXPC	기대
ARDUCT	기도
MV	기동
PILLAR	기둥
SKILL	기량
RCORD	기록
DCRY	기록물
DCRYMANAGE	기록물관리
DMNS	기록물관리기관
DLNGTD	기록물관리기관장
DCMN	기록물철
RCORDNO	기록번호
RCORDER	기록자
FHYP	기르는어업
OIL	기름
OLND	기름여과장치
OILTANKER	기름탱커
DECPTN	기만
TRMEND	기말
ENVNR	기말재고
SGNT	기명
SGTSL	기명날인
RGSTDB	기명사채
RGSTST	기명주식
VESSL	기물
SECRET	기밀
FND	기반
INFRSTRCTR	기반시설
INFRSTRCTRBNDPLAN	기반시설부담계획
ISRDN	기반시설부담구역
TECHNIC	기법
PRERPT	기보
BASS	기본
ENDW	기본금
BSLRY	기본급
BSMDL	기본모델
BAS	기본법령
BLFRP	기본복지점수
BASSDSGNBID	기본설계입찰
BSWYV	기본수로조사
BASSBIL	기본어음
BSCIMG	기본영상
ENDOWMNT	기본재산
BASSMESR	기본측량
PK	기본키
BASSSURFC	기본표면
BASSIEM	기본항목
CNTR	기부
CTBNY	기부금
CBMYS	기부금품
CRYRT	기부금품모집
CNTRBTR	기부자
TXCLCTPT	기분
ARTICL	기사
RECKN	기산
IDRK	기산일
WETHER	기상
GWTHCND	기상개황
WTHP	기상시설
WHRSV	기상업무
METRGCSTL	기상위성
KMA	기상청
WHRMR	기상측기
WETHERPH	기상현상
PARAST	기생충
LMNTHS	기생충질환
BSLN	기선
PXCOND	기성
SPIRT	기세
SSNSC	기소유예
STPRSC	기소중지
HRSMN	기수
BRHS	기숙사
TCHNLGY	기술
TCNDVLP	기술개발
CFLS	기술기반조성
TCNMTSYS	기술담보제도
TCNITCNTR	기술도입계약
TCNIDPRD	기술도입생산
SLC	기술문서
CRGRS	기술사
SKLKT	기술시장
TCNCDGRT	기술신용보증
TA	기술아키텍처
TCNTRNS	기술이전
ENGNR	기술인
TCNXPRT	기술자
TCNQLF	기술자격
TCHQVLN	기술평가
TCNINN	기술혁신
HUNGR	기아
DRFT	기안
DRAFTER	기안자
ARCSR	기압
BRMTR	기압계
MEMORY	기억
MYSTG	기억장치
ENTRPRS	기업
CRSCHC	기업구조조정투자회사
CPYY	기업도시
CMCPR	기업도시개발구역
CYPR	기업도시개발사업
CI	기업정체성
_G4B	기업지원단일창구
KMBNT	기업집단
ENTRPRS	기업체
CNWTH	기업체재산
CCVY	기업활동
CNTRBT	기여
PAYANNTY	기여금
ARTS	기예
TMPRT	기온
TILE	기와
ARFTSP	기용품
GENSIS	기원
DSCPN	기율
DUDT	기일
FLP	기입
RSTRD	기입등기
JRNLST	기자
MHRML	기자재
RGISTR	기장
STATE	기재
SIREN	기적
ECCN	기전
CDPNT	기점
ESTB	기정
ESTLBGT	기정예산
KYNT	기조
LEGACY	기존
LEGACYREGL	기존규제
LGCFRM	기존서식
HOST	기주
HSTRNG	기주범위
STDR	기준
STDPC	기준가
STDPC	기준가격
SNRMT	기준고용률
SDRT	기준금리
SNRN	기준금액
STDYY	기준년
SDNTY	기준수량
STDMT	기준월
STDRT	기준율
STDDE	기준일
CTRLPNT	기준점
SDFNC	기준주파수
SRLN	기준흘수선
CNTR	기증
BASE	기지
STTPRAR	기지보호구역
ORGNC	기질
TRAIN	기차
FLTAT	기채
BSIS	기초
BCRRC	기초과학연구
SLYBSLF	기초생활수급권자
CTRM	기초원재료납세증명서
BSDT	기초자료
ETC	기타
ETNT	기타건수
ETCAMT	기타금액
ETCLND	기타세탁물
OTHDVC	기타장치
DPSTN	기탁
TRUMNY	기탁금
RCBA	기탁반송
CYLCNT	기통수
DETONT	기폭제
BALT	기표
AVDNC	기피
TMLMT	기한
USNC	기한부
USNCBIL	기한부어음
BNFTM	기한이익
EFMY	기한후배서
SYMBL	기호
MARRIED	기혼
OPRTNTY	기회
PLANNG	기획
PLAUDT	기획심사
PLNTRV	기획여행
MPB	기획예산처
PLNER	기획자
CLMT	기후
MCMC	기후생태계변화유발물질
EMRGNCY	긴급
EMGPAUC	긴급공매
EMGDTY	긴급관세
EGNCR	긴급구조
URRCNINST	긴급구조관련기관
URRINSTT	긴급구조기관
URSPINSTT	긴급구조지원기관
EMGREPA	긴급수리용품
URGCAR	긴급자동차
ERGY	긴급조정
EMRRS	긴급체포
EMGCLEN	긴급통관
ACTNEC	긴급피난
INTMCY	긴밀
IMPRTNC	긴요
TENSN	긴장
STRET	길
ROADSD	길가
SRDGR	길가장자리구역
LT	길이
DP	깊이
OICOCC	까르네담당자
CANCLRC	까르네통관
TO	까지
VX	꼭짓점
PACKAGE	꾸러미
HNYB	꿀벌
BOILPT	끓는점
END	끝
NANO	나노
NATECH	나노기술
NNTB	나노튜브
DV	나눗셈
NATION	나라
RMNDR	나머지
TREE	나무
SCREW	나사
LL	나열
BARBOAT	나용선
BATCHAR	나용선계약
AGE	나이
NEIS	나이스
BRGRD	나지
DAIRY	낙농
THNDBLT	낙뢰
DRPSTRT	낙차공
SCSBID	낙찰
SUCBIDR	낙찰자
FLBHN	낙후
FLBNDR	낙후지역
FSHHP	낚시어선
FSHTB	낚시어선업
FKSBSM	낚시어선업자
FSHLC	낚시터
RAILNG	난간
WTZONE	난대
FIREPLC	난로
REFGEE	난민
HEAT	난방
ASTI	난시
ICTR	난연재료
DFFLY	난이도
SBTRPCL	난지
OBSTNCY	난치성
IRTLS	난치성결핵환자
DE	날
WING	날개
WETHR	날씨
SLNG	날인
DE	날자
DATE	날짜
DE	날짜
DTTM	날짜일자
ATMRSR	남극광물자원
ATNCBCRN	남극조약협의당사국
ATNCTRN	남극조약협의당사국회의
SPRGN	남극지역
ATRAPL	남극토착동식물
ANTEVR	남극환경
ATCACT	남극활동
ATCACTSU	남극활동감시원
STHNC	남남갈등
MWMN	남녀
RKLDFRS	남벌
STHNPT	남부
NRSTKR	남북
GOIKT	남북교역물품
NRSTKR	남북한
TKR	남북한횡단철도
SKEC	남북행사비교
SNVRS	남북회담
NAMSAN	남산
MALE	남성
ABUSE	남용
MALE	남자
SOUTH	남쪽
STHK	남측
SKRP	남측인물
SKPCR	남측인물경력
HUSB	남편
STHK	남한
SDPA	납골
CHRNHOUS	납골당
CHRNGRV	납골묘
CHNFCT	납골시설
CNLWR	납골탑
DEDT	납기
BRDDT	납기전
AFTDTE	납기후
PSNSC	납본
PAY	납부
PAYAMT	납부금액
PAYMTHD	납부방법
TAXPAID	납부세액
PAYDE	납부일
PAYER	납부자
PAYPLC	납부처
PNOP	납부최고
KPPT	납북자
TAXPAY	납세
TAXPNTC	납세고지
NOBLTAX	납세고지서
SYXY	납세담보
DNODP	납세독촉
SITP	납세보증보험
TAXPADE	납세신고
TPA	납세심사
AUDTSEC	납세심사과
PLFTP	납세의무자
TAXPYER	납세자
TXPASCT	납세조합
TXPCRTF	납세증명제도
TAXPLC	납세지
PAY	납입
PDSGUS	납입가장
PAYAMT	납입금액
PAYDE	납입일
PAYER	납입자
PAYPLC	납입처
DVYFG	납품
DLVGBIZ	납품업체
WASTE	낭비
DAYTM	낮
ISE	내
INMDC	내과
IRPP	내관
DURA	내구
DRBL	내구성
DOMSTC	내국
DOMCOMP	내국기업
DTCG	내국물품
CODOGDS	내국물품확인
DCLPS	내국법인
INTTAX	내국세
ILNTRDRN	내국운송
DOITRAN	내국운송신고
NATIVE	내국인
DSDP	내국인면세점
WWDMO	내국작업
MOIPAY	내국지급수단
CFKR	내국통화
DMSXCG	내국환
ONCN	내금
DWLD	내려받기
INREN	내륙지역
INCNDEP	내륙컨테이너기지
UNDE	내복
INNER	내부
SECINV	내사
LXTN	내선
IWRS	내수면
INLH	내수면어업
WRRMR	내수재료
DTLS	내역
DTSTMN	내역서
INOUT	내외
CN	내용
USLFSVC	내용년수
CNTYP	내용유형
TOMO	내일
ITRDECO	내장
ITRDCCNTR	내장용기
RSERTHQK	내진
ERDSGN	내진설계
NDTHLM	내피
PDFS	내항기
HMNR	내항선
IMTRNPT	내항운송
FFCRC	내화구조
SMELL	냄새
CUL	냉각
CULWTR	냉각수
CULNT	냉각재
CDYSM	냉난방
REFRIG	냉동
RNDMN	냉동공조기기
RFRMCN	냉동기
RFRGRNT	냉매
ARCLNG	냉방
CLTDR	냉조풍지대
BT	너비
NULL	널
AR	넓이
NO	넘버
NTWRK	네트워크
NTWRK	네트웍
YY	년
FYER	년간
YEAR	년도
YREND	년말
YYCNT	년수
YM	년월
DE	년월일
ANVSR	년제
WLR	년중
OBT	노거수
SHDRD	노견
LABOR	노동
MOLAB	노동부
LBT	노동쟁의
LBUN	노동조합
NODE	노드
YELLOW	노랑
SNGRUM	노래방
KBRB	노래연습장업
EFFORT	노력
RDSRFC	노면
LBRC	노무
LBNG	노무관리
LBM	노사
LMGR	노사관계
LBGT	노사분규
JLRGRC	노사협의회
FCRD	노상시설
STKLT	노상주차장
ROUTE	노선
RYNS	노선업종
HMLS	노숙인
HMPSN	노숙자
ODBLR	노약자
OVNTY	노유자
ODSN	노인
OLLR	노인복지
HSFHG	노인정
ELRBS	노인학대
LBADM	노정
LBUN	노조
MLNN	노조원
EXPSR	노출
NOTE	노트
NTBK	노트북
SPANUAT	노후
ENLF	노후
RUST	녹
MELTPT	녹는점
GREEN	녹색
RECRD	녹음
GTD	녹조
GREENS	녹지
GRNZN	녹지대
RECRD	녹취
TRPLANT	녹화
RICFLD	논
RFLDFRM	논농업
LOGIC	논리
LOGICL	논리적
LGCLFL	논리파일
THESIS	논문
DSCSN	논의
TNAGMNT	논조
CRTCSM	논평
PLY	놀이
FRMHS	농가
AGRI	농경
FRLND	농경지
IRCLS	농공단지
BSKT	농구
BSKTCRT	농구장
FRCN	농기계
FMHPS	농기구
DNSTY	농도
AGLFRS	농림
MAF	농림부
AFRTFSH	농림수산
QIA	농림수산검역검사본부
ACFMPRD	농림수산물
AGLFSFH	농림어업
AGAFR	농무
FARMER	농민
FRMPRD	농산
FRMPRD	농산물
FPCG	농산물이력추적관리
ALTFPR	농산식품
AGMRPD	농수산물
AMPRJMR	농수산물공판장
AMPWMR	농수산물도매시장
AGCHM	농약
FMFRM	농어민
FRHL	농어촌
FMVLTB	농어촌관광휴양사업
PULEAFC	농어촌생활환경정비사업
FSLTR	농어촌용수
FMVSHN	농어촌주민
FSVGS	농어촌주택
STRD	농어촌특별세
SCXTMT	농어촌특별세법
FARMNG	농업
FRMNG	농업경영
ATMNENT	농업경영체
FCH	농업기계
PMF	농업기계화사업
ARCTLD	농업기반시설
ARBEQRM	농업기반시설관리권
AGCRPT	농업법인
FARMNGPRDCTNINFRSTRCTR	농업생산기반시설
PSEAP	농업생산기반정비사업
AGCTINC	농업소득
ARIMNTXP	농업소득세할
EQRCR	농업용시설
ACHRSR	농업유전자원
FRMER	농업인
ARLTCLM	농업재해
ARTLVT	농업총조사
NFRMIC	농외소득
NFRMIC	농외소득원
FRC	농작물
FMWRK	농작업
AGADMS	농정
FRLND	농지
AGRLD	농지전용
FMLG	농촌
RDA	농촌진흥청
ARGLVPRD	농축산물
AGSPT	농특세
HG	높이
BNG	뇌공학
BRSC	뇌과학
BRIBE	뇌물
BRNL	뇌사자
CRBRPLS	뇌성마비
CLNRV	뇌신경
BRRSH	뇌연구
ENCPHLT	뇌염
BRNPHRM	뇌의약학
CBVCACD	뇌졸중
WHO	누가
ACMTL	누계
MNYY	누년
OVSITE	누락
RPOFNS	누범
LKGE	누설
WTLKG	누수
SILKWRM	누에
COCOON	누에고치
ACCMLT	누적
ACMAT	누적액
ELCLKG	누전
PGSTRT	누진처우
LKG	누출
SNW	눈
PPL	눈동자
NWM	뉴미디어
NEWS	뉴스
NWSM	뉴스통신
NSMNBS	뉴스통신사업
NWSBS	뉴스통신사업자
JPNELM	느릅나무
ZKYTR	느티나무
RYMSLM	능
ABLTY	능력
EFCNC	능률
NICKEL	니켈
KNIT	니트
NTRGCR	니트로글리세린
NTRGCL	니트로글리콜
NCNM	닉네임
MLTDWL	다가구주택
MUTDSYS	다계층분산시스템
MUTNACP	다국적기업
MLTFNC	다기능
MLTSTG	다단
MMKT	다단계판매
MVLRR	다단계판매자
MUCH	다량
BRIDGE	다리
MLSS	다면평가
MLTPRPS	다목적
MLTPRPSDAM	다목적댐
MLPXHOU	다세대주택
MLTTD	다수
MPDD	다수공급자계약
HGYL	다수확
MHMR	다습
TEAHOU	다실
DVRSTY	다양성
DWLD	다운로드
DOWNZG	다운사이징
DWSTM	다운스트림
PLRLISM	다원적
NEXT	다음
DIOXIN	다이옥신
MLTBRDG	다인승
MLTLTRL	다자
MLTLTRL	다자간
MNYCH	다자녀
MULTI	다중
FTBNPL	다중이용시설
MLTFLR	다층
POYMPM	다형성
STG	단
UNTPC	단가
ONRG	단결권
STEP	단계
SRTPD	단기
SRTBK	단기금융업무
SRRMS	단기급여
SHRSP	단기시효
SRRM	단기임대차
SNGLNS	단독
SFTNK	단독정화조
ULTSTHRT	단독주주권
SLH	단독주택
TRNG	단련
TRMNL	단말
TRMNL	단말기
TMNEQIP	단말기기
TMNDUNO	단말기기고유번호
TMNUNT	단말장치
SCTION	단면
SCNVEW	단면도
SMPSNT	단문
SIMPLX	단방향
PRTEOM	단백체
PROVIS	단서
DSCNNC	단선
REGLT	단속
CRMINVG	단속자
ISPFCAL	단수검사
SIMPL	단순
ABACPT	단순승인
SMWR	단시간작업
SMPSYS	단식
WRD	단어
HTSLR	단열재
UNIT	단위
UNTCSTR	단위공사
UNTPRCS	단위공정
UNTK	단위과제
UTPOOL	단위과제풀
UNTCT	단위비용
YRPU	단위소요량
UITQUTY	단위실량
UNTVTAMT	단위투표금액
SRTSND	단음
SINGL	단일
SDFT	단일고장
SGLTRF	단일관세
SCTNR	단일용기
SCMST	단일유기화학물질
SIMPLFY	단일화
TERMNL	단자
TMNPLT	단자판
TMNBOX	단자함
BREAK	단절
FRG	단조
OTTKS	단주
HSMP	단지
GRP	단체
GRPJOIN	단체가입
RTCLVL	단체교섭권
OGBG	단체표장
RHFVC	단체행동권
SHRTEN	단축
SHRTWV	단파
STWRST	단파방송
SHWIFRCH	단파적외채널
JPNMPL	단풍나무
RTSTU	단합대회
MT	달
DOLLAR	달러
CLDR	달력
ACHIV	달성
ACHDGR	달성도
FOWL	닭
CHCKN	닭고기
CHRG	담당
OCLHG	담당관
CHARGER	담당자
TBCO	담배
TBCSTAX	담배소비세
MRTGG	담보
MRTGGPC	담보가격
PRS	담보가등기
MRTGGCNTRCT	담보계약
MRTGGAMOUNT	담보금액
RRGWS	담보물권
MTGBND	담보부사채
SUPSCTY	담보제공
EXFSECT	담보제공의면제
OMSUSEC	담보제공의생략
RBTSY	담보책임
PRARACT	담합행위
STTMNT	담화문
RICFLD	답
ANSWER	답글
ANSWER	답변
ANSWRR	답변자
ASWPER	답안
REPLY	답장
PPRTY	당
BLRDRM	당구장
CNCNRY	당국
THSTRM	당기
THSYY	당년
GLYCSR	당뇨
CNFRNT	당면
PRTDUE	당비
CNCNRY	당사국
ISRTY	당사자
STNDSU	당사자적격
WIN	당선
TTM	당시
MHGCWM	당연상인
EFC	당연직
PARTM	당원
THSMON	당월
TODAY	당일
PRTGVN	당정
CKNT	당좌
BNDT	당직
BNDYR	당직간부
WTDTRM	당직실
PRZWIN	당첨
PRVWNM	당첨금
PRZWNER	당첨자
BGNN	당초
PRTINT	당해
LRGE	대
PRICE	대가
EVNY	대가변제
CRSR	대간첩작전
CRWTPY	대간첩작전보상대책지원금
OUTLINE	대강
DG	대구
DG	대구광역시
DGNAMGU	대구광역시남구
DALSEO	대구광역시달서구
DALSEONG	대구광역시달성군
DGDONGGU	대구광역시동구
DGBUKGU	대구광역시북구
DGSEOGU	대구광역시서구
SUSEONG	대구광역시수성구
DGJUNGGU	대구광역시중구
LRSCL	대규모
LCLW	대규모개발사업
CNGMRT	대규모기업집단
SPRSTOR	대규모점포
LRGRP	대그룹
PRIC	대금
METPAY	대금결제방법
WAIT	대기
ARMNDST	대기관리권역
WTPD	대기기간
LFCT	대기능
LTRS	대기업
LGNPP	대기업자
ARPLTN	대기오염
ARPLT	대기오염물질
ESRSNS	대기오염물질배출시설
FPRP	대기오염방지시설
WAIT	대기중
WTFF	대기차선
CLARACT	대기환경보전법
PRXPAY	대납
PRXPAYER	대납자
DMST	대내
DSTRN	대내외
BTLION	대대
MPLIS	대도시
MLNG	대도시권
EQLTRM	대등
LQTT	대량
LGC	대량거래
CNVCTN	대류
CNTT	대륙
INTRCNT	대륙간
CNLHF	대륙붕
TNSTRWAY	대륙철도
AGNCY	대리
AGCYTH	대리권
CMGN	대리상
CUPBP	대리수속
AGENT	대리인
AGENCY	대리점
HEMP	대마
CNBS	대마초
SBSTT	대물
LBSTS	대물대차
PAYSBST	대물변제
TWDAMRC	대미
TWDCVLN	대민
JSTPMC	대법관
SCOURT	대법원
CJSMR	대법원장
CRDIT	대변
WTRCLS	대변기
CRDNOT	대변표
GNRCL	대별
LOAN	대부
LOANMN	대부금
BLN	대부업
EXGIKTR	대북반출입물품
LCLAS	대분류
PROVS	대비
VERSUS	대비
CMPNSP	대사
AMBSSDR	대사
MTBLSM	대사
GODEMB	대사관물품
MTBLC	대사성
TRGET	대상
TRGCNT	대상건수
TRGAMT	대상금액
TRGTHNG	대상물건
TARINSP	대상사업장
TRGSHP	대상선박
PRVENT	대상업체
TRGTER	대상자
TRGCLM	대상청구권
MATGS	대소사
BDDBT	대손
BTD	대손상각
ALGE	대수
IRCRN	대습상속
DASH	대시
ALTRV	대안
LEND	대여
LONMN	대여금
HRHG	대여료
LNDS	대여업
LENDER	대여자
BAND	대역
EXTRNL	대외
EDCF	대외경제협력기금
FGTRACT	대외무역법
MEINPAY	대외지급수단
SBSTIT	대용
MEMBER	대원
GLSIMO	대원수
OVRDFT	대월
SUROGA	대위
SUBRGT	대위변제
LRTY	대유형
CNTRMSR	대응
REPRSNTV	대의원
TWDPSN	대인
PRSNLSCR	대인담보
REGSTR	대장
LDGRFL	대장구분
LGSNC	대장암
LEDGERINFO	대장정보
CNFRT	대적
DJ	대전
DJ	대전광역시
DAEDEOK	대전광역시대덕구
DJDONGGU	대전광역시동구
DJSEOGU	대전광역시서구
YUSEONG	대전광역시유성구
DJJUNGGU	대전광역시중구
RSRVD	대절
CMPRSN	대조
CLGGRD	대졸
LENDR	대주
HYSLR	대주주
MASS	대중
PBTRNSP	대중교통
PPLCMN	대중교통수단
PPLTEQP	대중교통시설
PPLTOPER	대중교통운영자
MSMDA	대중매체
PPLMSC	대중음악
PLRZ	대중화
PLOT	대지
PXPAY	대지급
EBRXY	대집행
DBRT	대차
BLHT	대차대조표
CNTRPLN	대책
CNTRMSR	대처
ALTRTV	대체
REPLC	대체
FUGODS	대체가능물품
SUBGODS	대체물품
EBRXY	대체집행
LON	대출
LDMY	대출금
LNRN	대출자
CONFR	대치
SYMM	대칭
ATTRPRG	대테러계획
PRESDNT	대통령
PSS	대통령경호실
ELPRSDNT	대통령당선인
PREDECE	대통령령
CWD	대통령비서실
PRSDNCY	대통령직
REPRSNT	대표
REPRSNTRCORDNO	대표기록번호
REP	대표기준
DLG	대표단
DPY	대표당사자
RRNVT	대표소송
CXFC	대표이사
RPRSNTV	대표자
SHUNT	대피
PULOUT	대피로
UNIV	대학
UNIV	대학교
UNVLBR	대학도서관
GDHL	대학원
KOTRA	대한무역투자진흥공사
KOREA	대한민국
RCFKP	대한민국국민
RKRRP	대한민국법인
RCKRH	대한민국선박
KCAB	대한상사중재원
KRC	대한적십자사
CONTMEA	대항조치
VRSC	대행
VCCP	대행감사
VCSNP	대행감사위탁감사
VXTTT	대행검사기관
LGZ	대형
BCNTR	대형공사
LSMN	대형금속용기
BNST	대형용기
LTK	대형주
CONVRS	대화
CNFRNC	대회
DAM	댐
DAMMNGR	댐관리자
DGFS	댐사용권
ANSWER	댓글
DMMYTBL	더미테이블
MRINF	덕망
DUCT	덕트
DUMP	덤프
DMP	덤핑
ATDUMTY	덤핑방지관세
MAGDUMP	덤핑차액
COVR	덮개
DELINK	데드링크
DEMON	데몬
DCBL	데시벨
DATA	데이타
DATA	데이터
DTGRM	데이터그램
DTLNK	데이터링크
DTWRH	데이터마트
DTBRS	데이터방송
DATABASE	데이터베이스
DA	데이터아키텍처
DW	데이터웨어하우스
DTMM	데이터통신
DEPOT	데포
DELTA	델타
DO	도
SWORD	도검
NTLN	도곽선
UNT	도구
PLTNG	도금
OUTSRC	도급
ROBR	도난
GODSTLO	도난분실물품
PRVNCL	도내
REACH	도달
ARRVL	도래
ROAD	도로
RNNN	도로관리청
RDSC	도로구간
RBEP	도로기종점
RDNWSYS	도로망체계
RN	도로명
RNBM	도로명기본도
RDNMBIZ	도로명사업
RDNMFCT	도로명시설
RDNMADR	도로명주소
RNAD	도로명주소데이터베이스
RNAIC	도로명주소통합센터
RBLNG	도로부속물
RNSC	도로운송차량
PRVCPRK	도립공원
WHSAL	도매
WLLDRC	도매배송서비스
WLTPR	도매시장법인
WHLSALR	도매업자
WHLSALR	도매인
DOMN	도메인
DOMN	도메인이름
DRW	도면
DRWKND	도면류
GAMBLE	도박
PRVCTN	도발
WLKG	도보
BNRPC	도산
RODBED	도상
ISLNDS	도서
LBRRY	도서관
LBRRYDTA	도서관자료
IDSRTS	도서벽지
PILTG	도선
PILT	도선사
FRYB	도선사업
PLINTN	도선수습생
FERAGE	도선업
FERRY	도선장
GLRS	도소매업서비스업총조사
MNBR	도수
CTY	도시
CTYGASBSNS	도시가스사업
CTYGASBSNM	도시가스사업자
URBDVAR	도시개발구역
UBDVPJ	도시개발사업
CTYPLN	도시계획
UBPLPJ	도시계획사업
CTYPLNTX	도시계획세
UBPLFC	도시계획시설
UBPLFCPJ	도시계획시설사업
CTYPARK	도시공원
CTYMANAGEPLAN	도시관리계획
CTRT	도시교통권역
BRPN	도시기본계획
CTYTRPLANT	도시녹화
CTLRK	도시자연공원구역
URBAR	도시지역
CTYRLROAD	도시철도
CYLQP	도시철도시설
DGRM	도식
DESGN	도안
MAPDMC	도엽
POTRY	도예
APPR	도용
ASSTN	도움
HPCM	도움말
DOLND	도유지
INDC	도입
CTPNT	도장
ESCAP	도주
ARVL	도착
AVLNOTC	도착보고
ALSHCUH	도착예정지세관
ALOC	도착지
CNDCTR	도체
SLAU	도축
BCHRTX	도축세
DDUC	도출
CHART	도표
DGM	도형
MYPY	독과점
NCRGD	독려
SLVCLTRST	독림가
INDPNDNC	독립
INDS	독립공채
_CIS	독립국가연합
INDPNDNCDET	독립채무
READ	독서
READRM	독서실
TOXCTY	독성
TXCGAS	독성가스
TXCHMSBST	독성화학물질
TOXIN	독소
POISN	독약
MNPLY	독점
EXCONCT	독점계약서
EXIMPOTR	독점수입권자
URGE	독촉
DMNTTP	독촉고지
URGSHT	독촉장
SELFSTDY	독학
OUTBRK	돌발
GST	돌풍
DONG	동
APTCMPL	동
LIVTGT	동거
ESTLNGTD	동경
WTRSN	동계
SYNC	동기
SNNRK	동기식전송망
SYNCHRN	동기화
SEASIA	동남아
_ASEAN	동남아국가연합
POWER	동력
PWRBOT	동력선
PALU	동력수상레저기구
PWRFSBT	동력어선
CRK	동료
DONGLI	동리
DGMN	동면
ANIMAL	동물
VTRHSPT	동물병원
ZOO	동물원
BRTTL	동물진료업
ACMPNY	동반
ACPFMLY	동반가족
CMPN	동반자
MLTADRCL	동보통신
ESTPRT	동부
NEASIA	동북아
DONGOFC	동사무소
MVBLS	동산
RROM	동산물권
PLDGMOV	동산질
STATU	동상
STGR	동석
FLWPSG	동승자
SMTM	동시
SMTMTRNS	동시전송
AMPLT	동식물
DURG	동안
SMTRD	동업
MVP	동영상
MBLZ	동원
MBLZPLAN	동원계획
ISTP	동위원소
AGRE	동의
WRTCNS	동의서
SYNONM	동의어
SAMENSS	동일
SMER	동일인
MOTION	동작
DYNM	동적
DYNMINTRPRTN	동적해석법
COIN	동전
IDTCGOD	동종동질물품
EAST	동쪽
MOVE	동태
FRZBUR	동파
ECRL	동해선
CNCDNT	동행
TGRPN	동행인
TREND	동향
CLB	동호회
PIG	돼지
PORK	돼지고기
SWVR	돼지콜레라
THICK	두께
_BK21	두뇌한국21
HAIR	두발
JAMD	두절
SMLPOX	두창
RVRSD	둔치
CRCMFRNC	둘레
RR	뒤
DRIVER	드라이버
DRYCANR	드라이컨테이너
GTSR	득점
PLSCR	득표
LSTN	듣기
LMP	등
CTRLN	등고선
GRAD	등급
RGIST	등기
RGSBUK	등기부
RGSOFC	등기소
RTL	등기용지
RTCD	등기원인서면
RSRFC	등기필증
FLCTS	등락
FLCTSRT	등락율
REGIST	등록
RSCT	등록건수
RGRFC	등록관청
RTRMN	등록사업자
RGRND	등록상표
RGSTAX	등록세
SNO	등록순서
RTLDL	등록실용신안
RTPR	등록업체
RGSDE	등록일
REGISTER	등록자
REG	등록자명
CEREGRT	등록증
RSCTFT	등록증명서
TRNSCR	등본
MTNRNG	등산
PMNTN	등산로
ISBRSF	등압면
GRAD	등위
KERO	등유
REGST	등재
DDAY	디데이
DRCTRY	디렉터리
DRCTRY	디렉토리
DMN	디멘전
DMN	디멘젼
DEVICE	디바이스
DISK	디스크
DSPLY	디스플레이
DIZPM	디아제팜
DESIGN	디자인
DSNREG	디자인등록
NSGFDN	디자인무심사등록
ICTD	디자인심사등록
DGTZER	디지타이저
DGTL	디지탈
DGTL	디지털
DGTLCLTURCNTNTS	디지털문화콘텐츠
DGTZTN	디지털수치화
DRM	디지털저작권보호
DRMR	디지털저작권보호권한
DRMP	디지털저작권보호정책
DIGCAM	디지털카메라
DGTLCNTNTS	디지털콘텐츠
DTLFSC	디지털포렌식
DGTZ	디지털화
DCDR	디코더
DCD	디코딩
DFLT	디폴트
DPTR	디프테리아
OR	또는
CVR	뚜껑
LANN	라니냐
RADIO	라디오
RBUOY	라디오부이
RAMN	라면
LBL	라벨
ROUTER	라우터
ROUTNG	라우팅
LING	라이닝
LINE	라인
LNE	란
RAFTNG	래프팅
RACK	랙
_LAN	랜
LNRD	랜카드
RAM	램
WRAPER	랩퍼
QY	량
RUSIA	러시아
RMICON	레미콘
LEVEL	레벨
LRLT	레벨조정기
RADAR	레이더
RAID	레이드
LYR	레이어
LASER	레이저
LSR	레저
LSRT	레저세
RSIDNT	레지던트
RECORD	레코드
RCDCNT	레코드건수
RTRVIRS	레트로바이러스
RPT	레포트
RENDRR	렌더러
LENS	렌즈
RNTCAR	렌터카
LOGO	로고
LOG	로그
LOGOUT	로그아웃
LOGIN	로그인
LOGIN	로긴
RODMAP	로드맵
LNC	로드밸런스
ROBOT	로봇
ROW	로우
LOCAL	로컬
ROPE	로프
ROLDWN	롤다운기준
ROLUP	롤업기준
LOGTON	롱톤
CHRGE	료
ROOT	루트
ROUTN	루틴
LOOP	루프
LPBCK	루프백
LOOPDEVICE	루프장치
RULBOOK	룰북
HSTD	류
RT	률
LI	리
RIG	리그
LEADR	리더
REMDELNG	리모델링
RIBBON	리본
RESRCE	리소스
LEASE	리스
LSEINDR	리스산업
RISK	리스크
LIST	리스트
RECALL	리콜
LITER	리터
RPSTR	리파지토리
REFRESH	리프레시
ANSWER	리플
RELAY	릴레이
RING	링
LINK	링크
CLOS	마감
BFRL	마감전
AFTCS	마감후
MGM	마그네슘
YARD	마당
HRSPW	마력
PREPRTN	마련
PRLYS	마비
MASK	마스크
MASTR	마스터
MASTRBL	마스터선하증권
MSTPL	마스터플랜
NRCTC	마약
NRCD	마약류
NKNCR	마약류범죄
DGDDT	마약류중독자
NCCN	마약류취급자
DRGTRFK	마약밀매업자
DRGSMG	마약밀수
DRGOFNR	마약범죄자
DRSRCTY	마약산출국
DRTGCTY	마약소비시장
SADTRA	마약조사요원
MOUSE	마우스
VILAGE	마을
SEWER	마을하수도
MNR	마이너
MCRPHN	마이크
MCRFLM	마이크로필름
MLG	마일리지
LAST	마지막
MARGIN	마진
ANES	마취
TRQGN	마취총
MARKT	마케팅
LTCAR	막차
EXPRTN	만기
EPNT	만기금액
MATRDM	만기상환
MTD	만기일
AFTEXP	만기후
END	만료
ENDDE	만료일
CHDSES	만성병
CHIFDIS	만성전염병
CHDSES	만성질환
BFLWTR	만수
FLDT	만재흘수선
PSCORE	만점
SATSFC	만족
STSFDG	만족도
HAPYCAL	만족도확인전화
DINNER	만찬
DINPRE	만찬참석자
CRTUN	만화
MLR	말라리아
NDNEK	말목
ERSR	말소
CCGST	말소등기
LY	말일
PNS	말초신경계
CLR	맑음
TASTE	맛
NTWK	망
MANG	망간
GBION	망태
NMHC	망향의동산
FIXES	맞춤
CLMSER	맞춤형서비스
SALE	매각
SELR	매각자
INTRMD	매개
EVEYR	매년
MNL	매뉴얼
MNGR	매니저
MNGR	매니져
SALE	매도
SLMT	매도금액
SLNT	매도수량
SLER	매도자
SALNT	매도증서
RCLM	매립
RCLMLND	매립지
TRDE	매매
BRYNG	매몰
RSTRSAL	매석
LAYING	매설
UDGRDWR	매설지선
PRCHAS	매수
NMRS	매수
BUYER	매수인
BUYER	매수자
PRCHCLM	매수청구권
MNA	매수합병
MSMDA	매스미디어
SALNOTE	매약서
SMOKE	매연
EVEMTH	매월
DAILY	매일
PUCHAS	매입
PCSRDM	매입상환
PCSRNHS	매입임대주택
BILBOGH	매입환
STR	매장
BURL	매장
HRD	매점
MEDIA	매체
MDATP	매체형태
SELNG	매출
SALAMT	매출금액
MTCHG	매칭
MATRIX	매트릭스
TKOF	매표소
MAPNG	매핑
ECHTM	매회
BRLSRT	맥류
PULS	맥박
MNHL	맨홀
MAPNG	맵
BLIND	맹인
CNCLSN	맺음말
HEAD	머리
PRFACE	머리말
WTRTT	먹는물
WBCTH	먹는물공동시설
WRCCT	먹는물관련영업
SRWTT	먹는샘물
DUST	먼지
MLTMD	멀티미디어
MTCSPB	멀티미디어문화콘텐츠설비제공업
MLTMDCNTNTS	멀티미디어콘텐츠
MLTCST	멀티캐스트
MGPON	메가폰
MENU	메뉴
MEMO	메모
MORY	메모리
MSSAGE	메세지
MTPHM	메스암페타민
MSSAGE	메시지
MSNGR	메신저
MJR	메이저
MAIN	메인
MNMNU	메인메뉴
MANFRM	메인프레임
EMAIL	메일
META	메타
METDATA	메타데이터
MTSEQ	메타세쿼이아
MEAQLN	메타콸론
CH4	메탄
METON	메트릭톤
MBR	멤버
MSR	멤버스카드
MBRSH	멤버십
MYEON	면
ITRVW	면담
TAXXPT	면세
EPMTT	면세기관
EPMPS	면세대상자
GEDFA	면세범위초과물품
PPDFG	면세상품인도장
DUFRSHP	면세점
TXFRISYS	면세제도
REDECLR	면세통관의뢰서
RFNTD	면세통로검사대
DUFREAW	면세허용범위
NOPG	면수
IMMU	면역
AR	면적
INTRVW	면접
EXEMPT	면제
ACQTR	면제자
DSMSL	면직
EXPRLS	면책위험
LCNS	면허
LNX	면허세
LCNSE	면허증
ANDOMT	멸각
DEVTON	멸실
EXTRMN	멸종
ERLR	멸종위기야생동식물
ENSPC	멸종위기종
NM	명
CMMND	명령
PRCEPT	명령서
CMGG	명령어
XLCMPSTN	명문
NMST	명부
DTLS	명세
DTSTMN	명세서
BSPOT	명승
CLRT	명시
CLRFCYFD	명시이월
HONOR	명예
EPSSR	명예교수
VNRYR	명예퇴직
DHCTR	명예훼손
NM	명의
TRFNM	명의개서
NMCHANGE	명의변경
NMTRUSTEE	명의수탁자
TTLTRST	명의신탁
NMTGG	명의신탁약정
NMLPSN	명의인
NMLPSN	명의자
NATHLD	명일
MTND	명장
HOLIDY	명절
NMTG	명찰
PTSTMK	명치
NM	명칭
NMPLT	명패
NCRD	명함
MOTHER	모
NCNY	모국
MYS	모금
MQT	모기
MNTR	모니터
MONTR	모니터
MNTRNG	모니터링
MODEL	모델
MODL	모델
MODEM	모뎀
MODULE	모듈
MODE	모드
SAND	모래
MM	모멘트
MOBILE	모바일
MSSYS	모바일서비스시스템
PRGN	모범
RECRIT	모병
SLRLY	모부자가정
SLRLY	모부자가족
SWRZ	모부자복지단체
GROPE	모색
MTHVESS	모선
MTHOPT	모선사
MOWS	모선식어업
MHRHDC	모성보호
CNTRDCT	모순
SHAPE	모양
MHRSM	모유
IMT	모의
MEETNG	모임
MHRHL	모자
MLDTB	모자보건사업
MHRLD	모자보건요원
MOSC	모자이크
IMTA	모조
IMTN	모조품
RCRIT	모집
RCRESTBL	모집설립
RCRUNDT	모집인수
RCRENP	모집종사자
BLNKT	모포
VNTBRLD	모험대차
MDL	모형
MOK	목
WTN	목격자
WDSTRT	목구조
WRTRT	목구조기술자
MGNL	목련
LIST	목록
EGLC	목록통관특송물품
THUR	목요일
BATH	목욕
BTBS	목욕장업
BTHHOU	목용탕
STKFRM	목장
TIMBER	목재
PURPS	목적
COUDES	목적국
PURPSBY	목적별
BRMP	목적별분류체계
OJTT	목적세
OBJ	목적어
DSTN	목적지
POTDESN	목적항
WUDCRV	목조
CNTNT	목차
CNTNTPTH	목차경로
FORAGE	목초
GOAL	목표
OBCTR	목표가격
MBO	목표관리
OSNY	목표관리제도
TRGCTPC	목표원가
TRGPFT	목표이익
CNFSC	몰수
CTTL	몰수품
BDWGH	몸무게
BODY	몸체
GRAVE	묘
YNGPLNT	묘목
TOMSTON	묘비
GRVYRD	묘소
BDFV	묘역
GRVY	묘지
NTHG	무
WT	무게
INTGRTY	무결성
CLMNY	무고죄
MTRACH	무공
MTMRMD	무공포장
FRPOLTN	무공해
ORDMLMR	무공훈장
LBLYT	무과실책임
MYCRC	무관후보생
SHRNRS	무궁화
GOMGH	무궁화대훈장
UNATHRRP	무권대리
UNPAID	무급
WEAPON	무기
UNRGSTDBT	무기명사채
BRSK	무기명주권
UNRSCR	무기명증권
UNRGSTBND	무기명채권
SPLDWT	무기체계채택물자
INCOMPT	무능력자
WTRMS	무단
TRNWPEM	무단양도
UNMRTG	무담보
UNSCRDBT	무담보사채
STAGE	무대
PRFMART	무대예술
STST	무대장치
DNCG	무도
DCHL	무도장
INCPCT	무력화
FREE	무료
FMYNCY	무료직업소개사업
ANONMS	무명
WHDVN	무배당
NNPY	무보수
FINE	무사
CLENBL	무사고선하증권
GRTS	무상
GRTSCNTRCT	무상계약
GRTSCNCS	무상양여
BSST	무상주
FSWHR	무상증자
WRLESS	무선
WRST	무선국
WRSLN	무선랜
RDRCFND	무선방향탐지
RDEQIP	무선설비
RENFER	무선종사자
WLMC	무선통신
RDNAVG	무선항행
DSRGRD	무시
WHAT	무엇을
CMMRC	무역
VBDS	무역거래기반
VDRRC	무역거래기반시설
BDSDFR	무역거래기반조성
VBPRN	무역거래자
MCHSHP	무역선
TRADER	무역업자
ADWHNT	무역유관기관
CMMRCATM	무역자동화
CMMRCATMBSNS	무역자동화사업
TRDEXHINDRY	무역전시산업
TRDEXHB	무역전시회
ANTHRCT	무연탄
NINTR	무이자
MNLSS	무인
FRDE	무임승차
INSOLT	무자력
RANDOM	무작위
AEPAG	무장간첩
PWRD	무적자
WLTHY	무전
NSTR	무점포
RTSR	무점포판매
UNLIMIT	무제한
INCNC	무죄
BHMLS	무주택
BHLHLR	무주택세대주
NGPT	무체재산
NBKK	무통장
UNLMLBL	무한책임
UNLIMPRTN	무한책임사원
NRT	무허가
FRMLS	무형
IGLST	무형문화재
NPYIMRT	무환수입
NPEXPRT	무환수출
UNAVBL	무효
BUNDLE	묶음
DOOR	문
LBRY	문고
WORDS	문구
DSRDR	문란
ILTRCY	문맹
DOC	문서
DOCDVS	문서과
DOCMNGMT	문서관리
EDMS	문서관리시스템
DCMNNT	문서보존관리기관
DOCCRD	문서카드
DBX	문서함
DRAFT	문안
INQRY	문의
INQPRP	문의성
INQR	문의자
REFRNC	문의처
CHRCTR	문자
SMS	문자메시지
CHARST	문자열
SNTENC	문장
QUES	문제
CNTRVS	문제점
CLRK	문집
CNSRE	문책
LTRTR	문학
QESITM	문항
LTRTRE	문헌
METOR	문형금속탐지
MEDEGAT	문형금속탐지기
CLTUR	문화
MCT	문화관광부
CLTURINDUST	문화산업
CRCX	문화산업단지
ISTSNL	문화산업전문투자조합
CRLRM	문화산업진흥시설
CLTURGOODS	문화상품
CTLSTT	문화시설
CLTURART	문화예술
CRLTS	문화재
OCP	문화재청
WATER	물
PRICES	물가
PRCTRND	물가동향
PCINDX	물가지수
PRCSTAT	물가통계
THING	물건
RLRT	물권
PAYGUD	물납
MTRMOB	물동
GTQY	물동량
VOLM	물량
LGIST	물류
CLCGR	물류관리사
DSTNS	물류사업
LGISTEQP	물류설비
LGISTFC	물류시설
LGISTSYS	물류체계
LGSSTD	물류표준화
LGSMDR	물류현대화
PHYSICL	물리
PHYSIC	물리적
PHSBRR	물리적방벽
PHSPRTC	물리적방호
PHYSCL	물리파일
BARTRD	물물교환
GUDS	물자
MTRL	물적
MTRSUR	물적자원
MRLZ	물적편성주의
MTTR	물질
THNG	물품
OFRSHET	물품매도확약서
LSFGD	물품목록
ITGD	물품목록정보
CECAGD	물품반입확인서
CEREGD	물품반출확인서
MLFD	뮤추얼펀드
UN	미
UNCLTLND	미개간지
UNDVLOP	미개발
UOUCARG	미검화물
INACT	미결
UNBALNC	미결산
UNCVCPER	미결수용자
UNSNCT	미결재
PENDNCY	미결정
UNSETL	미결제
RCS	미곡종합처리장
_USA	미국
DEA	미국마약청
ASTM	미국재료시험협회
USARMF	미군
AAFES	미군영내상점
MMLNM	미기상
NPY	미납
NPYAMOUNT	미납금액
DFLTR	미납자
LACK	미달
MDWR	미들웨어
UNRST	미등기
UNREGIST	미등록
MEDIA	미디어
FUTURE	미래
VSMAMT	미량
PREVEW	미리보기
BELO	미만
YTRTD	미복구
UPRPD	미비
MSSL	미사일
UKNWN	미상
NRDMP	미상환
MCRRGNSM	미생물
MCRBLGY	미생물학
MNRTY	미성년
CHLD	미성년자
MINU	미세
DEMIN	미소기준
ATMPT	미수
UNCOLECT	미수
UNCHKD	미수검
UNCLAMT	미수금액
UNRCIV	미수납
ATPCRME	미수범
IRFNT	미숙아
FART	미술
ATCRF	미술공예
ARTGR	미술관
ATGT	미술관자료
ASRY	미술사학
WRKART	미술품
USASTY	미식
SUPRST	미신
UNACMSLT	미실적
LSTCH	미아
BFRHP	미연
INCMPL	미완
BTY	미용
CSMTLGY	미용업
CNTSP	미임용자
AMRCA	미주
UNKNOW	미지
UNPAY	미지급
UNPAY	미지불
NOTARV	미착
UNPROCESS	미처리
NTPRTN	미추진
METER	미터
ESMC	미풍양속
INCMP	미필
_USA	미합중국
UNSOLV	미해결
SINGLE	미혼
UNMRMTH	미혼모
DOLLAR	미화
UNCNFRM	미확인
NTRFD	미환급
NTRFD	미환부
UNCLECT	미회수
INSFFC	미흡
PRVATE	민간
CLDNT	민간관리주체
ETSVN	민간위탁
CVLFC	민간자격
PVTINVST	민간투자사업
SNSTIVE	민감
TPJCMU	민군겸용기술사업
CLNS	민방위
BRGRC	민법
CFRS	민사
CVCS	민사사건
CVLST	민사소송
CJRC	민사재판권
CLRR	민사조정
CVTY	민사책임
NCCCPY	민사회사
FLTMS	민속
ETFH	민속신앙
ETNSC	민속악
PPLFLNG	민심
PRVOPR	민영
PVTPRS	민영교도소
PMUMPWM	민영농수산물도매시장
PVTHOUS	민영주택
PVTMNG	민영화
CVPL	민원
CFFDN	민원사무
CPTTR	민원인
PRVLND	민유지
PVTCPT	민자
PCIP	민자유치사업
RPL	민정
ETHNIC	민족
DMCRC	민주
DMCRTC	민주적
DMTFG	민주정치
DMCRCY	민주주의
ACDPU	민주평화통일자문회의
DMCRTZ	민주화
DCRZV	민주화운동
CVPRSLN	민통선
DN	밀도
SMUGL	밀수
SMUGER	밀수꾼
SMUGLNG	밀수출입
CRMSMUG	밀수출입죄
CRBARTC	밀수품
INTMT	밀접
CRWD	밀집
ARSPC	밀폐공간
ARTGHT	밀폐시설
SCPS	밀항
SACL	밀항단속법
MIK	밍크
ND	및
CRDQR	밑술
OCEAN	바다
SEAAGRG	바다골재
SEAFRM	바다목장
BOTTOM	바닥
BEACH	바닷가
WIND	바람
GLAN	바로가기
IDX	바로미터
VOUCH	바우처
CPTVR	바이러스
VIRS	바이러스
BIO	바이오
BCHP	바이오칩
VITAL	바이탈
BYTE	바이트
BRCD	바코드
EXHB	박람회
THNFLM	박막
MUSEUM	박물관
MFDT	박물관자료
DR	박사
APPLS	박수
BOXQTY	박스수
BAN	반
HT	반기
RTURN	반납
RRNQNT	반납수량
RTNPSN	반납자
OPPS	반대
CONTOFR	반대청약
SEMICNDCT	반도체
RETURN	반려
RETURNER	반려자
REPTIT	반복
ANCRP	반부패
RFLECT	반사
RFLBRD	반사판
ANTISC	반사회적
CRSSC	반소
RETRN	반송
CNRECRG	반송대
RETRNER	반송자
CRRR	반송파전력
REFLCT	반영
SMPRMN	반영구
RFLRT	반영율
ROUND	반올림
RESPNS	반응
TKIN	반입
ABCAGDS	반입사고
CRRPSN	반입자
SMAUTO	반자동
ASDRTOR	반장
SECCHF	반장
RA	반지름
TKOUT	반출
TKINOUT	반출반입
TKOUTER	반출자
PADAM	반파
DSTRIB	반포
RTNGUD	반품
RETURN	반환
BRAKT	받침
POL	받침목
DISLOS	발각
PBLCT	발간
PBLCTE	발간물
DSCVRY	발견
RDATE	발광
LNSL	발광소자
UNEARTH	발굴
NTSS	발권
ISSU	발급
ISSUER	발급자
PRJCTR	발기인
PRJASCT	발기인조합
MOTN	발동
GNFD	발령
SELLNG	발매
INVN	발명
INVNTER	발명가
INVNTER	발명자
ATFSS	발병
ISUE	발부
SHOT	발사
FRE	발사
LCVCL	발사체
OCCRRNC	발생
OCTY	발생수량
SNDNG	발송
SENDER	발송자
FRWAR	발송지
DSPTCH	발신
SRTTS	발아시험
CRCNS	발암
CRCNG	발암성
CRNGN	발암성물질
SPKNG	발언
PYRXIA	발열
CLRVAL	발열량
ITNC	발의
DVLP	발전
ELTGNR	발전기
ELYRS	발전사업
ETCTS	발전사업자
ETRQ	발전설비
ELCPWSTN	발전소
ORDER	발주
ORNT	발주기관
DRRL	발착
SLECTN	발췌
BLAST	발파
PRESNATN	발표
PBLICTE	발행
ISU	발행
IPC	발행가액
PBLISR	발행인
PBLISR	발행자
PBLSHR	발행자
ISTC	발행주식
IGN	발화
IGNDVC	발화장치
FERMN	발효
DISPLY	발휘
BRGHT	밝기
BRGHTN	밝음
BTRY	밧데리
ROOM	방
DCWTR	방류
VISIT	방문
VISITR	방문자
CLSL	방문판매
CRMPRV	방범
MTH	방법
MTHDLGY	방법론
BARI	방벽
DEFNS	방비
RLSE	방사
RDMTR	방사
RADIAT	방사선
RRENP	방사선관계종사자
RDADMAR	방사선관리구역
RGD	방사선발생장치
RDLGST	방사선사
RWENP	방사선작업종사자
RDIOACT	방사성
RDSTOP	방사성동위원소
RDOSBST	방사성물질
RDOWST	방사성폐기물
DNNPL	방산물자
BRDCST	방송
BSVC	방송구역
BDCST	방송국
BRDTR	방송사업자
MTHD	방식
METHOD	방안
DFNS	방어
DSNFC	방역
FRRST	방염
TLVISE	방영
DFNSE	방위
AZ	방위각
DFNSEINDUST	방위산업
DTRS	방위산업시설
DFRP	방위산업체
DEFTAX	방위세
SDFCL	방음시설
NTFRN	방임
DSPRVN	방재
CTMTRCT	방재실
PRVNBE	방제
SEAWAL	방조제
PRVN	방지
ASCLS	방진시설
HRNG	방청
RELS	방출
NGLGNC	방치
POLCY	방침
BRKWTR	방파제
DSTRBNC	방해
DRC	방향
PRTECT	방호
PTWALL	방호벽
FRPRVT	방화
ARSON	방화
FRTCC	방화구조
FRDOOR	방화문
FRWL	방화벽
FILD	밭
BCRN	배경
BGDMS	배경음
BGDMS	배경음악
PIPNG	배관
VLLB	배구
VLLBCRT	배구장
VNTILAT	배기
DSPLVL	배기량
SHPLT	배길이
SHPDP	배깊이
BANNER	배너
SHPBT	배너비
DLVR	배달
ALOT	배당
DVDND	배당금
DNRM	배당기일
DDNRT	배당률
PRFMDSTR	배당변제
DDDC	배당소득
BADM	배드민턴
BADMCRT	배드민턴장
BAREL	배럴
BCKSD	배면
EVAC	배변
DLRY	배부
DLRVER	배부자
DSTB	배분
REPRATN	배상
INDMNTY	배상금
ENDRS	배서
WIRING	배선
EXCR	배설
ASSGN	배속
DLVY	배송
DRNG	배수
SRVRSV	배수지
EMBRYO	배아
CLTVT	배양
ARRAY	배열
ALGN	배열
SPOUSE	배우자
MGNFC	배율
BFST	배임죄
SPLEPWR	배전
SWTBRD	배전반
ECPSRB	배전사업
ECRTR	배전사업자
DSRN	배전선로
ALLOT	배점
ASIGN	배정
EXCL	배제
CARALC	배차
CARALRM	배차실
EXHST	배출
DSCAMT	배출량
DHGP	배출시설
DHGRN	배출자
BATCH	배치
POSTNG	배치
LYTDSN	배치설계
LRT	배치설계권
EXCLSV	배타적
ECLCZ	배타적경제수역
BTRY	배터리
WDTB	배포
ARDD	배합사료
REAR	배후
BKGRND	백그라운드
PLTNUM	백금
BGTS	백두대간
BCKBN	백본
BCKBNNTWK	백본망
PT	백분율
WGSN	백삼
WHITE	백색
WTP	백서
VACIN	백신
BACKUP	백업
INCN	백열
WHPCGH	백일해
BLKENRS	백지배서
BHC	백지식배서
BKBL	백지어음
BNY	백지위임장
LLY	백합
DRTS	백화점
BLST	밸러스트
VALVE	밸브
SHFT	밸브대
VLVRM	밸브실
MSHRM	버섯
BUS	버스
VER	버전
VER	버젼
PLTNARF	버즘나무
BUTTON	버튼
BTTON	버튼
BUFFER	버퍼
BFR	버퍼링
PRPGT	번식
TRNSLAT	번역
LNBR	번지
LMRTY	번지유형
T	번째
NO	번호
MBLMB	번호이동
MLBTY	번호이동성
NOPLT	번호판
FNE	벌금
AMCMNT	벌금형
INSCT	벌레
DEM	벌점
FELLY	벌채
PENLCLS	벌칙
BK	벌크
BLKCARE	벌크선
FOVR	범람
LGD	범례
SLBOT	범선
SCOPE	범위
EXTMNGMT	범위관리
OFFNDR	범인
CNCOFD	범인은닉
OCRM	범인은닉죄
CRMNL	범죄
CMRRHP	범죄경력조회
GFRS	범죄수익
OFFNDR	범죄인
OFFNDR	범죄자
CIMS	범죄정보관리시스템
CDMG	범죄피해
CTGRY	범주
IRFL	범칙
PNALTY	범칙금
TRNSGRSOR	범칙자
CRME	범행
LAW	법
LRG	법규
LAWORD	법령
REVI	법령개정
ATTFORM	법령별지
ADRUE	법령부칙
FID	법령분야
EXAMRULE	법령예규
ANNO	법령운영공지
INF	법령정보
LAW	법률
LGAID	법률구조
JCFFR	법무
MOJ	법무부
BLL	법안
COURT	법원
MSTHR	법원보관금
BPFLW	법익
CPR	법인
CEO	법인대표자
JURIRNO	법인등록번호
JEGPRSN	법인사업자
CRRX	법인세
PRCTAX	법인세할
CPRAUDT	법인심사
DSSRP	법인해산
LGL	법적
CDFWS	법전
LEGAL	법정
LWCR	법정
LLTLY	법정계량
LFRTS	법정과실
LEGALMANAGE	법정관리
SRPRD	법정기간
LLRNT	법정대리
LGLRPS	법정대리인
LEGALDONG	법정동
LEGALLI	법정리
UNLA	법정외
LTFTS	법정이율
LEGALINTR	법정이자
LRRV	법정준비금
STTNM	법정추인
LGSL	법제
MOLEG	법제처
TXTLAW	법조
JCLCS	법조인
LAWKND	법종
JRSPR	법학
CHRTR	벚나무
BANR	베너
VECTOR	벡터
VENDOR	벤더
C6H6	벤젠
VNENTR	벤처
VNENTR	벤처기업
BNCH	벤치
BNCMRK	벤치마킹
BELL	벨
RCEPNT	벼
RICFRM	벼농사
THNDBLT	벼락
WALL	벽
WPRT	벽단자
BRK	벽돌
RMTPLC	벽지
CHANGE	변경
CHMNGMT	변경관리
CHANGETRGET	변경대상
RSDC	변경등기
CHGHY	변경사유
CNGYP	변경유형
CHGHST	변경이력
CHANGER	변경자
BFCHG	변경전
BTRHN	변경전후
AFTCH	변경후
CHANGE	변동
CHGHST	변동이력
FCTINT	변동이율
BFCHG	변동전
AFTCH	변동후
DSTBC	변란
DSCS	변론
PATATRNY	변리사
XPLNT	변명
CMPNSTN	변상
VRIABL	변수
TRNSFMR	변압기
MUTAT	변이
TRNSFRM	변전
SUBSTAT	변전소
REPAY	변제
ALTR	변조
CHGQLT	변질
CHNGE	변천
IRRGLTY	변칙
ABNINC	변태설립
MDFC	변형
DENSRT	변호권
LAWYER	변호사
COUNSL	변호인
CHNGE	변화
CHAGNT	변화관리자
CNVR	변환
CNVRTR	변환기
ACCTO	별
LSTL	별거
SPRGRP	별기
SPUSE	별도
SPSAL	별매
NCNM	별명
UNACBAG	별송품
STFC	별정우체국
PVGVPS	별정직
SCTS	별정통신사업
ENCLSR	별지
ATTAC	별첨
NCM	별칭
ATTLIST	별표
SICKNS	병
CURIMPT	병과
BNCTY	병과
GRM	병균
ORDNC	병기
WARD	병동
MLTPWR	병력
HSTCS	병력
PARLEL	병렬
PATHLOG	병리
PTHLOGY	병리학
BTLNCK	병목
MTRFS	병무
MMA	병무청
SLDER	병사
SCKBD	병상
SCKRM	병실
MTRSC	병역
BRCK	병영
BRCKLBRRY	병영도서관
AYL	병영생활
USJNT	병용
HSPTL	병원
PATHGN	병원성
PTHGOGAN	병원체
MTRRGST	병적
SRLS	병종사태
DLTHTS	병충해
MRG	병합
SDE	병해
DBYHS	병해충
PARLELSM	병행
BRRER	보
REINFC	보강
HELTH	보건
PHLEDU	보건교육
MOHW	보건복지부
PBHLTH	보건소
HMCCS	보건의료
HDNT	보건의료기관
PHMST	보건의료기술
HRCS	보건의료서비스
PHMP	보건의료인
HLSNR	보건의료정보
PRMEDIC	보건진료소
PRMEDICER	보건진료원
REPORT	보고
REPRT	보고서
REPORTR	보고자
CSTDY	보관
CHCY	보관료
DPSTRY	보관소
ONSMT	보국훈장
ECCNY	보궐선거
SUPPLY	보급
EX	보기
BONUS	보너스
BNUS	보너스
NES	보도
FTPTH	보도
RESRVE	보류
TRSURE	보물
RETORY	보복
RETYDTY	보복관세
REWARD	보상
CMPNSTN	보상
RWMNY	보상금
LFCPS	보상책임
JEWEL	보석
BAIL	보석
BNDED	보세
BDDR	보세구역
BATY	보세구역타입
BNDTRN	보세운송
PRBNDTRN	보세운송기간
DCLBTRN	보세운송신고
BTRNCOM	보세운송업자
BNDOPRN	보세작업
BDTM	보세제도
BNDWAS	보세창고
DUFRSOP	보세판매장
BNDDS	보세화물
BGF	보세화물운송주선
MENDNG	보수
MENDER	보수자
RPLNT	보식
SCRTY	보안
HFLRY	보안처분
SCRTKY	보안키
KPWRM	보온
LGGMTR	보온재
SPLEMNT	보완
SPPL	보완서
HOLD	보유
PSSINSTT	보유기관
HOLDER	보유자
NRTR	보육
DYCRCT	보육시설
NTPLD	보육시설종사자
BLR	보일러
GRNT	보장
GNTT	보장기관
PRESV	보전
PSVAR	보전구역
REVISN	보정
CORETON	보정
ASSTN	보조
SBMROD	보조간선도로
SBSIDY	보조금
SUBAGNCY	보조기관
SBSIDY	보조비
ASSTNFEED	보조사료
PRSRV	보존
PRSVRGST	보존등기
PSVASRT	보존종별
ASTANC	보좌
AIDE	보좌관
ADINSTN	보좌기관
ASSRNC	보증
GRNTY	보증
GTN	보증금
GRNTMR	보증부월세
WRGRNTI	보증서
LEGUNEG	보증서부매입
CTDCH	보증수표
GRNTR	보증인
GDTK	보증주
SYLS	보증채무
APPNT	보직
SPLINTR	보철구
SUPLE	보충
RSVDTY	보충역
SPLRUL	보칙
NRMLTY	보통
GNLSBD	보통교부세
CNM	보통명
GNLT	보통세
ONSK	보통주
BOAT	보트
UNIVRSL	보편적
STDNS	보합
PDSTRN	보행자
PEUR	보행자전용도로
INSRNC	보험
ISRBV	보험가액
INSRNCCNTRCT	보험계약
ILHD	보험계약자
TRMINRD	보험기간
INSRAGNT	보험대리점
SYNRR	보험대위
IRNCF	보험료
ICNY	보험사
PRLINS	보험사고
INRCN	보험설계사
ISCS	보험업
ABNDN	보험위부
CARR	보험자
IRBKR	보험중개사
INPCY	보험증권
ISTNT	보험환자
INSRNCCMPNY	보험회사
PRTC	보호
PROBAT	보호관찰
PRTCAREA	보호구역
PTINSTT	보호기관
NRSTR	보호수
FTSPT	보호시설
FGSTC	보호외국인
PRTCTOR	보호자
ECTSS	보호처분
RWDMRT	보훈
COVE	복개
RECOVRY	복구
LTTR	복권
REHBIT	복권
RTRN	복귀
CRRDPR	복도
CMPNINT	복리
WLFARE	복리후생
RPORT	복명
RPRT	복명서
SRVIC	복무
COPY	복사
COMPNO	복수
DTN	복식
BBETRBK	복식부기
TKMDGDN	복약지도
TAKNG	복용
RECOVRY	복원
RESTR	복위
CMPLCTD	복잡
UNIFRM	복장
RNSOFM	복적
REPRODC	복제
REPDUCT	복제품
WLFARE	복지
CMMRLCT	복지관
WSYSM	복지제도
REINSAT	복직
CWTH	복토
ABDPN	복통
LTTR	복표
BKTCL	복학
CMPND	복합
MUTRNBL	복합운송선하증권
CMWDS	복합운송주선업
CCRLRS	복합유통제공업
CMPUN	복합형
DECD	복호화
STRNGHLD	본거지
MPP	본관
PCPSKL	본교
ORIGNL	본래
MSTRM	본류
BDT	본문
MNNM	본번
BSLRY	본봉
HDQRTRS	본부
HEDOFC	본사
PRNOFC	본서
MLN	본선
BAYPLAN	본선적부도
MNNL	본선터널
ORGNTR	본성
PCPTAX	본세
BSU	본수
ORIBL	본안
ORIBDGT	본예산
SELF	본인
PRMDMCL	본적
PRMDMCL	본적지
HDOFC	본점
TRUNAT	본질
HEDOFCR	본청담당자
ADHEOFC	본청운영자
MFM	본체
PSNMT	본회
BALL	볼
VOLUM	볼륨
BWLAL	볼링장
BOLT	볼트
SPRNG	봄
SLARY	봉급
SRVC	봉사
BLKADE	봉쇄
SEALNG	봉인
ENVLP	봉투
SEAL	봉함
FATHER	부
ADI	부가
VAT	부가가치세
APND	부가물
ADISVC	부가서비스
VAT	부가세
ATPSY	부검
LEVY	부과
ASSES	부과과세
LTNT	부관
SMG	부관리자
ATPSS	부교수
BUKIP	부기
CTGT	부기등기
INDEPT	부내
LADY	부녀자
BND	부담
ALOTM	부담금
SHFCR	부담당자
GBCRS	부담부증여
INJSTC	부당
UNFRLBPRC	부당노동행위
UNJENR	부당이득
TAXUJENRCH	부당이득세
MRN	부대
SNPS	부대사업
SBRS	부대시설
DSHNR	부도
FLOAT	부동
ESTATE	부동산
ETLWR	부동산개발사업
REAP	부동산경매절차
RNPOS	부동산실명제
PLDGRP	부동산질
QUAY	부두
ODBARA	부두밖보세구역
ODCY	부두밖콘테이너장치장
PRGE	부두사용료
DOKRECT	부두수취증
TOC	부두운영회사
DEQ	부두인도가격
BNWHPER	부두장치장
DKCRSC1	부두통관1과
DKCRSC	부두통관2과
VAGRNC	부랑
VGBOND	부랑인
VGWFFCT	부랑인복지시설
APNDX	부록
CATGORY	부류
PARNTS	부모
SECT	부문
SLNO	부번
INSURG	부보
CVERNTE	부보각서
UFI	부보금융기관
DUCA	부본
MRD	부부
PART	부분
PRTINSPCT	부분감사
BBYP	부비트랩
ADVRB	부사
BS	부산
BGMCH	부산경남지역본부세관
BS	부산광역시
BSGANGSEO	부산광역시강서구
GEUMJEONG	부산광역시금정구
GIJANG	부산광역시기장군
BSNAMGU	부산광역시남구
BSDONGGU	부산광역시동구
DONGNAE	부산광역시동래구
BUSANJIN	부산광역시부산진구
BSBUKGU	부산광역시북구
SASANG	부산광역시사상구
SAHA	부산광역시사하구
BSSEOGU	부산광역시서구
SUYEONG	부산광역시수영구
YEONJE	부산광역시연제구
YEONGDO	부산광역시영도구
BSJUNGGU	부산광역시중구
HAEUNDAE	부산광역시해운대구
BYPRD	부산물
DUPRDUT	부산물공제
BYPRDFRTLZR	부산물비료
BRLRT	부산물석유제품
IBFBP	부산물수불대장
BYPRDSALT	부산물염
INJ	부상
INJPSN	부상자
DEPT	부서
DPRLR	부서장
BARGE	부선
ATTACH	부설
ATACH	부속
ATACHBILD	부속건축물
APNDG	부속기관
ADJNCTS	부속물
APPNDX	부속서
ADCLS	부속시설
ATTCH	부속용도
ATTLOTNO	부속지번
ACSRS	부속품
NBFPS	부수
BGFTY	부수시설물
CORRSN	부식
CRRS	부식성
INSFFNT	부실
ISNCG	부실금융기관
ISFRZ	부실우려금융기관
ISWYSC	부실우려조합
IVSSC	부실조합
ISTNY	부실징후기업
ISVBG	부실채권
SUPORT	부양
DNTMY	부양가족
SBLG	부양의무자
SUPORTR	부양자
SIDJOB	부업
ALWNC	부여
EXPTN	부연
STFER	부원
REGN	부위
FLTNG	부유
SBCNMT	부의사항
DENY	부인
GYNCLGY	부인과
ACOFC	부임
SUBMTR	부자재
SDEFCT	부작용
FRBRNC	부작위
ABSNCE	부재
ABSNT	부재자
DRSC	부재중
INADQC	부적격
ILBTYL	부적격혈액
DEAFRGT	부적운임
IMPROPT	부적정
IMPROPT	부적합
SBAGNT	부점
INSTC	부정
INSTCCMPETACTION	부정경쟁행위
TRAMPER	부정기선
DNIED	부정된
IRGCRP	부정부패
SUBTL	부제
SUBTITL	부제목
IRRTN	부조리
LACK	부족
EDEMA	부종
PLOT	부지
SLNO	부지번
DLLN	부진
SUBORD	부차
ASN	부착
XTRMTR	부착물
ATCHBRD	부착판
DEBT	부채
CBOOK	부책
MIRYFC	부처
ADRUE	부칙
BHUTN	부탄
FROM	부터
BOOTG	부팅
ROT	부패
IRGCRP	부패
CRRP	부패행위
CMPNT	부품
VALPART	부품가액
CNNTT	부품소재
SDPMT	부품소재전문기업
VL	부피
LOAD	부하
LOD	부하
SMBOL	부호
HTCYS	부화업
RESRECT	부활
VRMN	부회장
NORTH	북
BKMK	북마크
NTHAM	북미
_NLL	북방한계선
NRTPRT	북부
NTHTD	북위
NRTH	북쪽
NK	북측
NKER	북측인물
NKERFM	북측인물가족
NKERCR	북측인물경력
NK	북한
NSHBT	북한이탈주민
NRTKN	북한주민
MIN	분
MNT	분
BNHL	분가
DSTNGSH	분간
JRNLZ	분개
JRNLZPR	분개장
BNHH	분교
CLRGN	분구
DECNTL	분권
CMPLC	분규
QU	분기
TRNOUT	분기기
INSPY	분납
EXCRS	분뇨
ECSCS	분뇨처리시설
SHARE	분담
SHR	분담비율
MNTBY	분당
QNT	분량
CL	분류
SEPRAT	분리
SPRX	분리과세
MDSTRP	분리대
SPHST	분리배출
SPLLT	분리밸러스트
PARTRTN	분만
OBVISLY	분명
DNMNTR	분모
TOMB	분묘
DSTB	분배
DVDND	분배금
DSTRBT	분배기
SQRGUN	분사기
DS	분산
ANALS	분석
INSANAY	분석검사
PLCANY	분석소
SPANS	분석시료
CUSTLAB	분석실
ANAYREQ	분석의뢰
ANAJL	분석회보
CRUSH	분쇄
FUTN	분수
LOS	분실
REALM	분야
LTTOT	분양
LTTBS	분양사업자
LTTOTCNVRS	분양전환
DTRFEE	분여세
MOOD	분위기
PWDRMLK	분유
NMRTR	분자
DFWRL	분장
TRUBL	분쟁
CPNL	분전반
DST	분진
DTRK	분진작업
MNS	분초
DISTRB	분포
RSNDL	분필등기
PARTITN	분할
IPOCD	분할납부
PSOSS	분할선적
DVHP	분할소유권
PIMPDEC	분할수입신고
COIDP	분할증명서
RSRDT	분할채권
PRTAPLCTN	분할출원
DCOMP	분해
IMPRTY	불가
ISBLS	불가분채권
ITYY	불가사유
FORMAJ	불가항력
FRMJCUS	불가항력조항
NOPNPRT	불개항
UNWHLSM	불건전
INJST	불공정
UNFTRDPRC	불공정거래행위
INQLTY	불균등
BULLJANG	불기소장
DSTTRGPR	불기소장보존
DSTTSC	불기소처분
NPYMN	불납
NPYLS	불납결손
INCPCTY	불능
BULDZR	불도저
BADN	불량
DSDVN	불리
DSCNTT	불만
DSCNTT	불만족
BYCT	불매운동
INDSTNCT	불명
INJS	불명분
UNLAW	불법
UNLIFR	불법방해행위
UNLDSG	불법배출
UNLDSGEQP	불법배출시설
UNLISVLN	불법부실대출
UNLPRF	불법수익
UNLPFWLT	불법수익재산
UWFGEDG	불법외환거래
UNLRMV	불법이전
UNLWLT	불법재산
ILGDVSN	불법전용
IMMUTBL	불변
DSBDNC	불복
APLDIST	불복신청
FLRN	불소
UNACPT	불수리
NCNFDNC	불신임
QSTINSP	불심검문
POPUP	불쑥창
NLMBLT	불연
ICLT	불연재료
FRPRF	불연화
SDITUS	불온
INCMPL	불완료
DISUSE	불용
ATLD	불용품
DSDVNT	불이익
NFLFL	불이행
DSCRD	불일치
STRILZ	불임수술
PAYMNT	불입
PLYFR	불장난
ABSN	불참
IMNFARS	불체포특권
RTUN	불출
DCMFIDX	불쾌지수
NSN	불투
IMLYR	불투수층
SPARK	불티
INCNVNNC	불편
NDLS	불필요
ARDPUFK	불하물품
DSQLFC	불합격
NNPMSN	불허
FREOFFR	불확정청약
CLPS	붕괴
VIEW	뷰
VIEWR	뷰어
BRWSR	브라우저
BRBGMET	브라운백미팅
BRAND	브랜드
BRNSTON	브레인스토밍
BRDCT	브로드캐스트
BROKER	브로커
BDLRT	브롬화난연제
BRF	브리핑
BLCLST	블랙리스트
BNKR	블랭킷에어리어
_BLOG	블로그
BLCK	블록
BOS	블루오션전략
BLTH	블루투스
NON	비
CT	비
NTDR	비간부
NOSPV	비감리
UNRESID	비거주자
TRICK	비결
NNPT	비경쟁
RM	비고
CLSDR	비공개
NODDC	비공제
TAXXMPT	비과세
NNBNC	비과세소득
TAXXMTSTK	비과세주식
NTB	비관세장벽
CMPR	비교
NTSLR	비급여
NGLD	비녹지
VINYL	비닐
HYPTRPY	비대
_ADSL	비대칭디지털가입자회선
ASYNC	비동기
VIDEO	비디오
VPCS	비디오물
VPRTS	비디오물대여업
VDFR	비디오물시청제공업
PRPORT	비례
PRLAM	비례대표지방의회의원
FRTLZR	비료
FRZTD	비료업자
OBEST	비만
NSL	비매품
NMP	비면세대상자
EXPITM	비목
SECRET	비밀
PASSWORD	비밀번호
SRDG	비밀의장
STRV	비밀준비금
SRPT	비밀특허
SADNWS	비보
EMGNC	비상
ENCY	비상구
PRTMSVC	비상근
EPC	비상기획위원회
UNUSLSTP	비상단계
STEMRG	비상사태
UNLIST	비상장
SECRTRY	비서
AS	비소
DSCNDNT	비속
SLANG	비속어
NLTGCS	비송사건
SLKSSN	비수기
NOEDBL	비식용
NPPRF	비업무용자산
NRFRP	비영리내국법인
NFVNZ	비영리민간단체
NFCR	비영리법인
NTNR	비영리외국법인
BTP	비오톱
FRTLTY	비옥
CT	비용
VLATE	비위
RATE	비율
PPRPAY	비율급
NBDBIZ	비은행업
VISA	비자
STAHFND	비자금
VSN	비전
NOELEC	비전자
NPNLL	비점오염원
NCRDT	비정규
IRGLLBR	비정규직
ABNRM	비정상
NTDFN	비정의
AD-HOC	비정형
RELIMP	비중
NFTYCMP	비창
SVEMRG	비축
SVEMRGGD	비축물자
FRNSH	비치
FNHR	비치기록물
SLOPE	비탈
BIT	비트
NFTRMT	비특혜
NTCNC	비파괴검사
CRTCS	비판
NSTNRD	비표준
FXTRS	비품
FLYING	비행
ARPLN	비행기
FGHTY	비행안전구역
ARFLD	비행장
NDRBKGD	비환급물품
NMBR	비회원
POVRTY	빈곤
FQ	빈도
WPVR	빈부
UNINHBHOUS	빈집
ANEMIA	빈혈
BLDG	빌딩
BLGE	빌지
RWR	빗물
ICSPSTDM	빙상경기장
ISG	빙축열
DBT	빚
LIGHT	빛
RED	빨강
PROFS	사
FA	사
FO	사
SQRE	사각
INCDNT	사건
INCDNTRCORD	사건기록
SHOOT	사격
SUTRNG	사격장
DLSITU	사경
ACDNT	사고
DIRTBL	사고부선하증권
ACDNTEXAMIN	사고조사
OFSNDT	사관후보생
CMNL	사규
MORALE	사기
PRVNTPRZ	사기업
PRVNTPRZ	사기업체
WNMPY	사내
CGHMY	사내대학
LDDR	사다리
ARYDV	사단
CRGGRG	사단법인
PERSON	사람
LOVE	사랑
CMD	사령
CMNDR	사령관
CASE	사례
FEED	사료
HSRRL	사료
TRNIFED	사료화
COIL	사리
PVTESTB	사립
PVTUNIV	사립대학
PVTSKL	사립학교
PVTSKLMST	사립학교경영자
DEATH	사망
KILLDT	사망일자
DPRS	사망자
PARDON	사면
OFCRK	사무
OFFICE	사무소
OFICE	사무소사업소
OFFM	사무실
CLERK	사무원
SCRTRT	사무처
ECNR	사방
ECTRS	사방사업
ECLNT	사방시설
EMPNO	사번
CRIME	사범
JDCTR	사법
JDCPLCE	사법경찰
JDPLOFR	사법경찰관리
JDPLPWR	사법경찰권
JCST	사법공조
CNFLCT	사변
BRVMNT	사별
SLDR	사병
CYCLB	사보
SABTAGE	사보타주
PCPOF	사복교도관
MNSCRPT	사본
STILBR	사산
DTHINJ	사상
CASLT	사상자
SACUBRN	사상출장소
PVTLIF	사생활
LBRRN	사서
MLBX	사서함
POBOX	사서함
PVTESBL	사설
MINOR	사소
FACT	사실
FDPS	사실심
DCTRR	사실혼
CSE	사안
SPEC	사양
BSNS	사업
BLDBY	사업권유거래
BSR	사업분야
WCT	사업비
BIZPLC	사업소
OFCX	사업소세
BSNSYEAR	사업연도
BSS	사업용
TFFBU	사업용전기통신설비
BIZRLR	사업용철도
BTYP	사업유형
BSNSRCOGN	사업인정
BSNM	사업자
BSNMESNTLINFO	사업자고유정보
BPSS	사업자단체
BIZRNO	사업자등록번호
BIZRNO	사업자번호
BPLC	사업장
INDBC	사업장내
INDSWSTE	사업장폐기물
BSNSCNVRS	사업전환
BPRPRR	사업주
BSNES	사업체
CMMRCLZ	사업화
PVTINSR	사영보험
OUTCMPNY	사외
USE	사용
USGPLN	사용계획
USTLR	사용공차
RIOUS	사용권
USGPD	사용기간
LNS	사용대차
USGQTY	사용량
RNTFEE	사용료
USGSRHLD	사용본거지
USGBIPR	사용사업주
USGSTT	사용상태
USGTM	사용시간
ELST	사용시설
UDEON	사용신고
USGAMT	사용액
USEPRPS	사용용도
EMPLYR	사용자
USER	사용자
USRSPLP	사용자공급관
USRORG	사용자단체
USID	사용자아이디
IMPDPU	사용전수입신고
AFTUS	사용후
AUNFP	사용후핵연료처리
EMPL	사원
DECEIT	사위
PRVONSH	사유
RESN	사유
PRVWT	사유수면
PVTLND	사유지
BRD	사육
RPAYKND	사은
PRSNT	사은품
BTWN	사이
CYBER	사이버
CYBERATTACK	사이버공격
CBM	사이버머니
CYBERSAFE	사이버안전
SIZE	사이즈
CYCLE	사이클
SITE	사이트
DTHCS	사인
GCVDH	사인증여
RESIGN	사임
CVCR	사장
HDG	사장품
HRCSP	사적
HISTST	사적지
BEFFAT	사전
DICARY	사전
PCOCIA	사전동의
PMTCHG	사전매칭
BRHHC	사전선택
TAXADVN	사전세액심사
PREAUDT	사전심사
ADTMOPN	사전임시개청통지
IRCTS	사전제품검사
ADVNTCE	사전통지
BHEVAL	사전평가
ASESS	사정
VISA	사증
PHOTO	사진
CAMERA	사진기
INVSTG	사찰
PSNDBT	사채
CPRND	사채
DBNTHLD	사채권자
BDRP	사채모집
BDTR	사채원부
CTPLT	사출기
LXRY	사치
SITAT	사태
CNYS	사택
SNDSL	사토
RESIGN	사퇴
PVTSKL	사학
MATTER	사항
FRDACT	사해행위
SPCLTN	사행
SPCFR	사행기구제조업
SLTBS	사행기구판매업
SPCLAT	사행성
SPCLSPR	사행심
SPCTT	사행행위
BCTVT	사행행위영업
CPTPSH	사형
SOCTY	사회
_SOC	사회간접자본
INFRSTR	사회기반시설
SLRRTR	사회기반시설사업
SCRT	사회보장
SLNRC	사회보험
SYRNR	사회복지공동모금
SLLD	사회복지법인
SCRCS	사회복지사업
SSRS	사회복지서비스
SSRFT	사회복지시설
CTPSERY	사회안전저해물품
EMCEE	사회자
_SOC	사회자본
AFTFAT	사후
POSMANT	사후관리
FLPMN	사후관리
OCPMANT	사후관리담당자
POIMBFT	사후귀속이익
LARLCAG	사후도착물품
PCOAREQ	사후분석의뢰
POSAUDT	사후심사
RESELTY	사후심사선별
LIQUDTN	사후정산
PSEVAL	사후평가
REDCT	삭감
ARLCWY	삭도
DELETE	삭제
DTRN	삭제사유
DLTR	삭제자
MNTN	산
INFDBT	산금채
MTST	산림
MTSTG	산림골재
MTNRCL	산림문화휴양
MSRTS	산림사업
MNSSR	산림소유자
FRTRSC	산림자원
FRTCR	산림작물
FOA	산림청
FCLNG	산림토목기술자
MOTHR	산모
BULK	산물
MTLNBR	산번지
MNTNSTP	산보
FRFIRE	산불
LNDSLD	산사태
ACD	산성
OXGN	산소
HYPX	산소결핍
ARITH	산술
BIRT	산아
INDUST	산업
INDUSTTCHER	산업교원
INDUSTEDC	산업교육
ITRGC	산업교육기관
INFDBT	산업금융채권
ICPNN	산업기능요원
INDUSTINFRSTRCTR	산업기반시설
IRCCX	산업기술단지
IRSTT	산업단지
ITVPR	산업단지개발사업
ITPXMT	산업단지관리
IDRL	산업디자인
ISRLN	산업별노동조합
IIP	산업생산지수
INDUSTCNSUT	산업자문
MOCIE	산업자원부
IPRY	산업재산권
IDTYTW	산업재산권진단
INLC	산업재해
IACI	산업재해보상보험
ISLR	산업집적
ISSTR	산업표준
OISM	산업훈장
INCLS	산입
INDUSAC	산재
IACI	산재보험
CALC	산정
CMPVALE	산정가격
MTC	산지
DFNND	산지전용
WLK	산책
MTVL	산촌
MSLDR	산촌진흥지역
COMPUT	산출
PRDCTN	산출
OUTPUT	산출물
AFORGZ	산하기관
ACDINCP	산학협동
ACDINCP	산학협력
OXD	산화
NTGOXD	산화질소
FLESH	살
APRCT	살구나무
STERLZ	살균
GRMCD	살균소독제
WTSPKL	살수
SPKLR	살수기
MURDER	살인
FLEINS	살충
SPRAY	살포
LF	삶
TH	삼
THRD	삼차
SCHD	삼청교육
SSFF	삼청교육피해자
INSRT	삽입
UPPT	상
SOPSRT	상가
SRBLD	상가건물
DPRT	상각
DRLSS	상각자산
BIZDL	상거래
SETOFF	상계
CUTRDTY	상계관세
APEAL	상고
CRNTY	상공
CCAI	상공회의소
SUPRR	상관
COMPRC	상관행
TRDAR	상권
FTE	상근
RNFMD	상근예비역
AWARD	상금
UPCLS	상급
SUPRR	상급자
UPEND	상단
CNSLT	상담
CNSLTNT	상담사
CSLC	상담소
CNSLR	상담원
DCLTN	상담중
EQVLNT	상당
PARTN	상대
PTNCNT	상대국
FNRRIT	상례
UPSTRIM	상류
UPSTRM	상류
LNDG	상륙
FRHFYR	상반기
RWRPNS	상벌
COMACT	상법
SCKWND	상병
RUNION	상봉
SUPRR	상부
SPRSTRCT	상부구조물
SUPRR	상사
CMLMR	상사
CRCMY	상사회사
MHTSP	상선
PRMESTBL	상설
DETAIL	상세
DTLCLFC	상세분류
DLYP	상세유형
APEL	상소
INHRTNC	상속
INHRRT	상속권
IHRTN	상속법
SRINHR	상속분
ITNCX	상속세
IHRTY	상속재산
CONST	상수
WRPP	상수도
SRCWTSUP	상수원
ARCRL	상수원관리지역
HLCTC	상습
HBOFND	상습범
RISING	상승
ORDTM	상시
REGEMBK	상시승선
COMSEN	상식
RECOM	상신
FRFTR	상실
CMRC	상업
CMNCS	상업금융업무
CRGT	상업등기부
CMCEMP	상업사용인
COMDOC	상업서류
CTCR	상업신용장
CMRCSTDINRST	상업표준금리
BNS	상여
BONUS	상여금
SCRINNG	상영
CMCL	상용
COMSMP	상용견품
EDFAS	상용과다물품
GODSALE	상용물품
UPPER	상위
SNR	상위자
CRSPND	상응
CSLT	상의
DFFRNC	상이
PRMPST	상임
BOX	상자
LST	상장
STPAGE	상장폐지
STORE	상점
SOPSTR	상점가
SBMISN	상정
RESDNG	상주
SYMBOL	상징
UPLYR	상층
HLVCLD	상층운
STTUS	상태
STNG	상태변경
BEDPL	상판
BRAND	상표
TRDMKRT	상표권
TMDRSYS	상표권신고제도
BRANDUSE	상표사용
GOODS	상품
GCCT	상품권
GDTP	상품유형
GOODSSTOCK	상품주식
HHLW	상하
WSUPNDRN	상하수도
UPLMT	상한
UPLMTPC	상한가
INJURY	상해
ACINSR	상해보험
IRYCM	상해죄
UPPLN	상행
CMCLTN	상행위
UPWARD	상향
MTLTY	상호
CMPNM	상호
MFCPT	상호금융자금
MLYY	상호보증금
INTRC	상호작용
INTRCNNC	상호접속
MTLTYCNCRRNCPROCSS	상호합의절차
MLMNY	상호회사
RPAY	상환
REPY	상환
RPAYMNT	상환금
RPAYDE	상환일
RDMSTK	상환주식
RRVXH	상환준비금
SITTN	상황
BRFRUM	상황실
STTBRD	상황판
PZDCR	상훈
_KFCC	새마을금고
SMLMV	새마을운동
CLMTRL	색료
ACHRMTPS	색맹
COLOR	색상
DSKRMP	색약
INDEX	색인
CLMTRL	색재
CLOR	색채
CLRG	색칠
SPRG	샘
SPRWTER	샘물
SMPLE	샘플
SAMPLE	샘플링
LVLHD	생계
RRUBR	생고무
LIFYEA	생년
BRTHDY	생년월일
OMS	생략
PYSICLG	생리
PHSICLG	생리학적
MHLY	생리휴가
LIFE	생명
BTCHNL	생명공학
LIFESCNCETCHNLGY	생명과학기술
LIFEINSRNC	생명보험
LSRCB	생명보험업
LVB	생물
BTCHNOL	생물공학
BTPCD	생물농약
BCLVY	생물다양성
BLLN	생물무기
BINDST	생물산업
BSFE	생물안전성
BMDCN	생물의약품
ORMRC	생물자원
BIOEX	생물자원국외반출
BLCL	생물적
BIOSPC	생물종
ORGNSM	생물체
BTRR	생물테러
BLY	생물학
BLGEQV	생물학적동등성
LVBDT	생방송
LDTH	생사
RSILK	생사
PRDCTN	생산
PROST	생산기준
OUTTRN	생산량
PRDCTV	생산성
PRDALW	생산수당
MKER	생산자
PRDCORGN	생산자단체
PRDLC	생산지
RPAEXP	생산지원비용
PRODUCT	생산품
CREAT	생성
CRTR	생성자
BOTLW	생수
PRCRTN	생식
RPVG	생식기관
LFE	생애
HBDC	생약
RLD	생업자금
GRDV	생육
BRTHDY	생일
GTHGT	생장조절
BEING	생존
LBDY	생체
ECLGY	생태
ESTRCV	생태경관보전지역
ECSYSTM	생태계
ESSTC	생태계교란야생동식물
ECTRSM	생태관광
ECLGYVILAGE	생태마을
ECCRDR	생태통로
NCSTLF	생필품
BCHM	생화학
LVLH	생활
LVSPL	생활용품
SRTLL	생활체육
DOMWSTE	생활폐기물
NCSTLF	생활필수품
LFNRN	생활환경
SWRM	샤워실
OFE	서
BKSHLF	서가
LIBRR	서고
CCTF	서기
PAPERS	서류
FROST	서리
STM	서머타임
DOCMNT	서면
PINN	서면조사
SIGN	서명
SGNTR	서명인
SIGNER	서명자
GRFRS	서무
PRFACE	서문
SMLF	서민금융
SERVER	서버
SERLAD	서번트리더십
SURVEY	서베이
WSTPRT	서부
SUBNET	서브넷
SBMNU	서브메뉴
SVC	서비스
SRVC	서비스
SRVMNGH	서비스관리권한
SVRLST	서비스목록
SCNTY	서비스업
SVMR	서비스표
ERPP	서손
DSCRP	서술
PRDC	서술어
FORMAT	서식
HBTT	서식지
LETTER	서신
OCCDNT	서양
ORD	서열
CLGRP	서예
SU	서울
SU	서울특별시
GANGNAM	서울특별시강남구
GANGDONG	서울특별시강동구
GANGBUK	서울특별시강북구
SUGANGSEO	서울특별시강서구
GWANAK	서울특별시관악구
GWANGJIN	서울특별시광진구
GURO	서울특별시구로구
GEUMCHEON	서울특별시금천구
NOWON	서울특별시노원구
DOBONG	서울특별시도봉구
DONGDAEMUN	서울특별시동대문구
DONGJAK	서울특별시동작구
MAPO	서울특별시마포구
SEODAEMUN	서울특별시서대문구
SEOCHO	서울특별시서초구
SEONGDONG	서울특별시성동구
SEONGBUK	서울특별시성북구
SONGPA	서울특별시송파구
YANGCHEON	서울특별시양천구
YEONGDEUNGPO	서울특별시영등포구
YONGSAN	서울특별시용산구
EUNPYEONG	서울특별시은평구
JONGNO	서울특별시종로구
SUJG	서울특별시중구
JUNGNANG	서울특별시중랑구
CHIEF	서장
BOOK	서적
BLGRP	서지
WST	서쪽
CTBRR	서킷브레이커
GSWLY	서행
CNFR	서훈
STONE	석괴
CRSBW	석궁
XPLNRT	석명권
RSL	석방
MASTER	석사
PETRLUM	석유
OSTP	석유광산시설
OSRGY	석유대체연료
OTTGY	석유대체연료대리점
OBRGS	석유대체연료주유소
OBTGTR	석유대체연료판매소
OBTGS	석유대체연료판매업
OSTLD	석유대체연료판매업자
OLTTS	석유수출입업
OPTPT	석유수출입업자
PRINDSTR	석유정제업
RFNRD	석유정제업자
PTRPRD	석유제품
OLBS	석유판매업
OSRD	석유판매업자
BDST	석재
STAND	석차
COAL	석탄
CPRSB	석탄가공업
CPSSD	석탄가공업자
COLPRCPRD	석탄가공제품
CLMN	석탄광업
CNRD	석탄광업자
COALINDUST	석탄산업
LN	선
ELEC	선거
EST	선거구
EPSNMG	선거비용
ELCT	선거인
VIDFTM	선거인명부조회단말기
ELEDE	선거일
ADJU	선고
SPSC	선고유예
DRSS	선광
BRDGE	선교루
ADVAN	선금
ADVPAY	선급
PPAYMNY	선급금
CSFCR	선급법인
PREPAY	선납
FLEET	선단
PREAGE	선대
LDRSHP	선도
GPJCT	선도기술개발사업
INSTG	선동
LVRD	선량
DOSLMT	선량한도
SHPAGE	선령
RLWAY	선로
LNFLS	선로설비
RSLSWCH	선로전환기
RLWAMP	선로증폭기
PRISAL	선매
PLACTN	선무
GIFT	선물
FTRS	선물
FTSL	선물거래
FRPRD	선물스프레드
FSMT	선물시장
FRS	선물업
FTRTR	선물업자
FRP	선물옵션
FSHG	선물환
STRNLIT	선미등
POOP	선미루
SHIP	선박
CWH	선박공유자
SPNBS	선박관리업
SHPGR	선박관리인
NCOTV	선박국적증서
BUSOFS	선박급유업
SPLNTH	선박길이
SHDTH	선박너비
VSLDBIZ	선박대여업
SPRGTR	선박등기
SHPNBR	선박번호
SHIPACT	선박법
SHRN	선박보험
SHIPOWNR	선박소유자
BUSHREP	선박수리업
PRTSHP	선박우선특권
SPPRN	선박운용회사
VSSVCMPN	선박운항회사
SHPRGST	선박원부
AIS	선박자동식별시스템
SRGG	선박저당권
ASTQUA	선박전환승인
SHIPER	선박주
SHPL	선박직원
CLLSP	선박충돌
VSIVTCMPN	선박투자회사
SELECTN	선발
SELECT	선별
SELCINS	선별검사
LSCHART	선복용선계약
PRPAY	선불
ADPC	선불카드
EPAYDIS	선불할인
OBIWU	선상검사
OBEDEC	선상수출신고
BERTH	선석
PLAYER	선수
PRECDNT	선수금
FRCSTL	선수루
ENHC	선양
DCLR	선언
SUPVES	선용품
VSCSYS	선용품관리시스템
CREW	선원
CMYRCT	선원근로계약
SMLAW	선원법
ICCRW	선원보험
SPL	선원수첩
SFID	선원신분증명서
BFHOLD	선의의소지인
APNT	선임
FIFOM	선입선출법
MSTR	선장
SHIPNG	선적
SHPCONR	선적계약
CAAGDOC	선적서류상환불
SHRQEST	선적요구서
SHPREQ	선적요청서
DTASHP	선적일
BARDATE	선적일자
SHIPORD	선적지시서
PRLOAD	선적항
PRPGNDA	선전
SLCTN	선정
SELTR	선정자
SHPOWNR	선주
SPRSRC	선주상호보험조합
PREPAI	선지급
ADVNCD	선진
ADCNTR	선진국
FIRARR	선착
DOCK	선착장
PACBTDS	선착화물
APIER	선창
CTLFM	선천성이상아
ELECT	선출
PRIAPLC	선출원
NMTD	선충
PREOCUPY	선취
FAS	선측인도가격
CHOISE	선택
ALTDUT	선택관세
OPCM	선택채권
OPDB	선택채무
POPASEA	선편소포우편물
PRCLM	선포
_BL	선하증권
PRECDNG	선행
LINR	선형
PREFER	선호
DSGN	설계
DSGNSPRVISN	설계감리
DSGNSHRTCOM	설계결함
DSGNSTDR	설계기준
DSGNVE	설계속도
DSGNR	설계자
FOND	설립
RSRBH	설립등기
DC	설명
MNL	설명서
QUSTNR	설문
QESTNAR	설문조사
QESTNR	설문지
EQP	설비
PURG	설사약
ESTBS	설정
DTRMN	설정
SETUP	설정
INSTL	설치
INSTLR	설치자
ITLPC	설치장소
ESSH	설치지역
SNOWDMG	설해
FLMP	섬광등
ANHLTN	섬멸
FBER	섬유
LSN	섭외
NTK	섭취
FMNM	성
SEX	성
CHARCT	성격
SUCCES	성공
RSLT	성과
RLNPC	성과감사
RTV	성과평가
DNTN	성금
CMGMY	성년례
PRFOMNC	성능
SNGDONG	성동
FORMATN	성립
PRSTT	성매매
ARST	성매매알선행위
VSFR	성매매피해자
NM	성명
VTCR	성묘객
SRTT	성문표준
SEXDSTN	성별
VNRDSS	성병
IRDNT	성분
HHSN	성수기
MTRTY	성숙
MTRDG	성숙도
SNCR	성실
ADULT	성인
GROWTH	성장
GROWTHMANAGEAREA	성장관리지역
SCRE	성적
DISPOS	성질
IMAGO	성충
SCCES	성취
SCCESDG	성취도
SXVLC	성폭력
SLCS	성폭력범죄
INCLN	성향
SXHRS	성희롱
TAX	세
WORLD	세계
WRDECNM	세계경제
WCO	세계관세기구
_WTO	세계무역기구
_WHO	세계보건기구
_IBRD	세계은행
GLBAL	세계적
GWNT	세계표준시
CSMHSE	세관
CEN	세관감시망
CUINSPC	세관검사
CIPLACE	세관검사장
RFCINSP	세관검사통로
CUSTBUT	세관공보
CUSTDIR	세관관리자
BDWHCP	세관구내장치장
CUSRMK	세관기재란
CUSOFCR	세관담당자
CDDTD	세관마약탐지견
DPDGOD	세관반송대
CUSTSAL	세관봉인
UFCFAC	세관설비사용료
CUSINVC	세관송장
CUMASEC	세관운영과
SUMASEC	세관운영과장
CUSCOLT	세관장
CDCDEPT	세관출국신고대
CUSROUT	세관통로
CUSPCAG	세관특별감시반원
CCPUCS	세관특파공무원사무실
CACIS	세관화물정보시스템
SCOUR	세굴
BCLS	세균
BCTRL	세균성
SEGMNT	세그먼트
TAX	세금
TAXBIL	세금계산서
PCTPAY	세금사후납부
TPSTPAY	세금현장납부
HSHLD	세대
GNR	세대
RMSTHFAMINFO	세대원이력
RMSTNFAMINFO	세대원정보
HSHLDR	세대주
CRMCS	세라믹
PWR	세력
VRTICL	세로
VEL	세로길이
WSB	세면기
TAXITM	세목
TAXITEM	세목정보
TAXAFS	세무
RVNF	세무공무원
LNDCTN	세무사
TAXOFC	세무서
SEMINA	세미나
SEMITRLR	세미트레일러
HS	세번
TAXLAW	세법
DETAIL	세부
DTLCLFC	세분류
SESEMK	세세목
SESEHN	세세항
SESION	세션
TAXRVNU	세수
TAXAMT	세액
TAXDDC	세액공제
CORTAX	세액보정
NXRP	세외수입
TAXSRC	세원
TAXRT	세율
DTYDPGD	세율불균형물품
ANLRVE	세입
ARSTACNT	세입결산
ARKWAN	세입관
TXRVAMT	세입금
ARMOK	세입목
NARAECASH	세입세출외현금
ARBGT	세입예산
ARJANG	세입장
ARHANG	세입항
TAXREG	세적
BFRX	세전
TAXADM	세정
CNML	세정제
TASSYS	세제
CARWSH	세차장
CLNSG	세척
DTRGNT	세척제
ANEXPTR	세출
AESTACNT	세출결산
AEKWAN	세출관
AEGROUP	세출그룹
AEMOK	세출목
AESEMOK	세출세목
AESSHANG	세출세세항
AESHANG	세출세항
AEBGT	세출예산
AEJANG	세출장
AEHANG	세출항
DLRLS	세칙
LNDR	세탁
LNDRY	세탁물
WSBS	세탁업
CELL	세포
CLLN	세포주
SEHN	세항
AFTTX	세후
SECTOR	섹터
SENSOR	센서
CNTER	센터
CEL	셀
SFSRV	셀프서비스
SET	셋
STBX	셋톱박스
SMALL	소
INCNR	소각
THTS	소감
INTRCN	소개
OPIN	소견
SUBSUM	소계
JRSD	소관
RECORS	소구
RBAC	소권
SMLGRP	소그룹
SLAT	소금
RTROACT	소급
RERTAX	소급과세
SFCT	소기능
SSLENTR	소기업
PINE	소나무
PINKND	소나무류
GIRL	소녀
PLTN	소대
DSNF	소독
INCOME	소득
INDCT	소득공제
INCMTAX	소득세
IMCT	소득세법
PRITAX	소득세할
ECNCRP	소득작물
PRICM	소득할
SMLQY	소량
NRWROD	소로
SOUND	소리
RTLSAL	소매
RTLSALER	소매업자
RTLSALER	소매인
RTLSTR	소매점
EXTSH	소멸
ETPSC	소멸시효
EXPLN	소명
CNSUM	소모
CMPDS	소모품
FGT	소방
FHST	소방기관
FHNXP	소방기술자
FBRD	소방대
OJTFT	소방대상물
FGL	소방대장
FTGLNR	소방본부장
FRSTT	소방서
FRBT	소방선
FRMN	소방수
FFCNS	소방시설
FRGHTBIZ	소방시설업
FRGHEQIBZ	소방시설업자
FHDTY	소방업무
FFTH	소방용기계기구
FFGQ	소방장비
URINE	소변
UIL	소변기
SCLAS	소분류
CNSMP	소비
LCNM	소비대차
CNSMPQY	소비량
CMCLT	소비설비
CNSTAX	소비세
BJCP	소비임치
CNSMR	소비자
CNSMRGRP	소비자단체
CRPT	소비자보호법
ASMRP	소비자생활협동조합
SCHTWR	소상공인
PTMRCHNT	소상인
SLSTM	소생태계
SBSNY	소선거구
PSITN	소속
PPBLSRV	소속공무원
PLREA	소속공인중개사
PSTINST	소속기관
FRDMG	소손
DEUFRNC	소손해면책
LWST	소송
NFST	소송고지
OCLTGN	소송담당공무원
LLRSN	소송대리
ATRNPWR	소송대리권
ATRNY	소송대리인
LGXPSS	소송비용
SCSFG	소송승계
RTLFG	소송지휘권
APPL	소송청구
LWSTJUDMN	소송판결
ACTPRE	소송행위
DCML	소수
SMLCNT	소수
DCMLPOINT	소수점
MRTHRT	소수주주권
SOURC	소스
DSIPTN	소실
BFGHT	소싸움
BLFGT	소싸움경기
CHILD	소아
SMLAMT	소액
SSMC	소액결재
SLTT	소액결제
TEOSS	소액면세
SSGLVG	소액물품
SLDYM	소액심판제도
MRHL	소액주주
SLBND	소액채권
REQRE	소요
REQREQY	소요량
CBYRATO	소요량계산서
DCMYR	소요량산정방법신고
YRAUD	소요량심사자
CYRATO	소요량증명서
POSESN	소유
OWNSHIP	소유권
RTRRP	소유권보존등기
RNFND	소유물반환청구권
OWNER	소유자
OWNER	소유주
ONELND	소유지
SMLTY	소유형
NOISE	소음
NCRTRP	소음발생건설기계
NOISEOPERT	소음작업
NVRNLT	소음진동방지시설
NSHCY	소음진동배출시설
PSTMRK	소인
EL	소자
HDCH	소장
PSGUD	소장품
MATR	소재
MISSING	소재불명자
LOCPLC	소재지
POSSES	소지
POSESER	소지자
EXHS	소진
CNVC	소집
APPL	소청
INCT	소추
SOCKET	소켓
MLRD	소통
SOF	소파
PRCPOST	소포
PRCPOST	소포우편
PRCPOST	소포우편물
PARECPT	소포우편물수취증
PARFRGH	소포운임
_SW	소프트웨어
SWBS	소프트웨어사업
SWBSER	소프트웨어사업자
SWIND	소프트웨어산업
SWPC	소프트웨어진흥단지
SWPE	소프트웨어진흥시설
SMLRVR	소하천
SMRVR	소하천구역
ASLRV	소하천부속물
SLMC	소하천정비
SSIZE	소형
SLTTL	소형기선저인망어선
SMLLP	소형선박
SLRGN	소형저장탱크
SMLSTK	소형주
NEGLG	소홀
DIGSTN	소화
EXTSHR	소화기
FRPLG	소화전
SUMONS	소환
SUBOENA	소환장
STNGRPHER	속기사
VE	속도
BRKNEWS	속보
ATRB	속성
ATTRB	속성
SLANG	속어
DCNL	손괴죄
LSFY	손금
RNTF	손료
LOSS	손망실
LOSQUAN	손모량
LOSRATE	손모율
DAMG	손상
DDABAMT	손상감세
HNDCRT	손수레
LOSS	손실
INDMNFC	손실보상
LSTMN	손실액
PRFLOS	손익
PLOSDOC	손익계산서
BVNT	손익분기점
DMAGE	손해
CPNS	손해배상
CNSNG	손해배상조치
NFRNC	손해보험
ACINSE	손해보험업
NFSCP	손해보험회사
SOLNOID	솔레노이드
SLUTN	솔루션
REMIT	송금
SCHG	송금수수료
RMITER	송금자
DELVY	송달
LTG	송무
SENDNG	송부
TRSMRCV	송수신
TRNSMIT	송신
TRMOFC	송신소
TRNSMITER	송신자
TRSMDVC	송신장치
OPPL	송유관
OPLST	송유관관리자
OPSTLR	송유관설치자
INVC	송장
PWRTRN	송전
PTRSMBIZ	송전사업
PTRSMBIZER	송전사업자
PTLINE	송전선
CBLN	송전선로
SEND	송출
TRNSR	송치
INVE	송품장
WOT	송풍
BLOWR	송풍기
SECONG	송하인
SNDER	송화자
RPTR	송환
RNVT	쇄신
BEEF	쇠고기
SHOPNG	쇼핑
SOPMAL	쇼핑몰
CO	수
MCCHRG	수가
ISNNT	수감기관
HNDCUF	수갑
ATNLC	수강
TKAWY	수거
INSPTN	수검
WRSSM	수계
WCSRN	수계관리위원회
THT	수고
WTRTB	수관
WPOLO	수구
ATHZER	수권자
BILCLCT	수금
RECIPT	수급
SPLDMD	수급
RECIPTER	수급권자
CSADEMD	수급기업체
RCPBIZER	수급사업자
RECIVER	수급인
RECIPTER	수급자
MEMOR	수기
SUFER	수난
DSRRL	수난구호
SRFS	수난구호협력기관
RCIV	수납
TCAGENY	수납기관
RCVSLVDC	수납대비징수결정
RCVSCRNTAM	수납대비현액
RCIVER	수납자
MN	수단
ALLWNC	수당
CPTL	수도
WTWAY	수도
STLEMNT	수도결제
WTWORK	수도공사
NPLN	수도권
CTRNL	수도권매립지
CLRPR	수도권신공항
MRDPLN	수도권정비계획
CTLNR	수도권지역
FCT	수도꼭지
WLTN	수도시설관리권
TWFCCP	수돗물불소농도조정사업
PASSIV	수동
HOPR	수동
AGR	수락
QY	수량
PRCINSTT	수련기관
ANDCR	수련의
CLCT	수렴
RECPT	수령
RECPTR	수령인
WTCORS	수로
WRWF	수로정보
WYVT	수로조사
WYST	수로조사업
WVTGT	수로조사표
WSSR	수로측량
WRT	수록
COMPL	수료
CMPLTR	수료자
CTFHV	수료증
REPAIR	수리
ACPT	수리
RPCCS	수리부속품
RRCSN	수리위탁
PADACEP	수리전분석
CACEPT	수리취소
AADACEP	수리후분석
FOUNDNG	수립
SRFWTR	수면
SRMN	수면관리자
LGTFF	수명
RCM	수명자
WDPT	수목
ARBRTM	수목원
RSDLD	수몰이주민
FLUGT	수문
RECIP	수발
FLDCON	수방
SRCCRM	수배
WNMN	수배자
TCHNIQ	수법
WSZON	수변구역
RCVPAY	수불
INVST	수사
INVSTCAREERDTA	수사경력자료
IVSRH	수사경력조회
INVGTOR	수사관
IVGST	수사기관
MARN	수산
PRCSMRPD	수산가공품
MNLTS	수산동식물
MPRC	수산물
MRTSS	수산물가공업
MPCBS	수산물가공업자
NFIS	수산물안전부
MPGCACT	수산물품질관리법
MRNRT	수산생물
MLRRL	수산생물진료업
FSHRS	수산업
MNCSCS	수산자원
MRCTC	수산자원조성
TDTSFUD	수산전통식품
MLFSC	수산질병관리사
MNRR	수산특산물
FHSN	수삼
WNPZ	수상
AQTC	수상
WTRC	수상
ATRP	수상레저기구
ATSCT	수상레저활동
SRCHNG	수색
SECHWAR	수색영장
HANDW	수서
HDST	수석
RPAIRS	수선
FLTLT	수세식화장실
HYDRO	수소
FLDDMG	수손
TRNSP	수송
FEE	수수료
SURGR	수술
APNTC	수습
ANYTM	수시
ANTHEX	수시건강진단
NOMFRM	수식
RECPTN	수신
RCIVR	수신기
RCVFCLT	수신설비
RCVANTN	수신안테나
RCVER	수신자
RCVAPRT	수신장치
RCVAMP	수신증폭기
RCVOFC	수신처
RCVBOX	수신함
DPWT	수심
WTRPRSR	수압
WTPRGG	수압계
DELUG	수액
WPWL	수양버들
TUTFEE	수업료
CNFER	수여
WATERS	수역
BDTLPP	수연례
SWMPL	수영장
DMAND	수요
DMANDMANAGE	수요관리
DNTT	수요기관
DMANDGDS	수요물자
WED	수요일
ACEPTNC	수용
ACMD	수용
ACMDFCLTY	수용시설
PRISNER	수용자
WATSRC	수원
CTCHAR	수원지
WAL	수위
NRSG	수유
MRC	수은
VLTRN	수의
PRVCNTR	수의계약
VTRINRN	수의사
ERN	수익
ERNS	수익금
ERNRT	수익률
PRFTBL	수익성
ERNRT	수익율
BENFCRY	수익자
BNFCR	수익자
BYTFC	수익증권
ERNDEBTR	수익채무자
ACPTINSTT	수임기관
INCME	수입
IMPORT	수입
IMCLSEC1	수입1과
IMCLSEC	수입2과
IMPINSP	수입검사
IMCNR	수입국
PIIMPRT	수입금지품목
MRREVN	수입대체경비
IMPAGNT	수입대행업자
CIPDECR	수입분할증명서
IMPRTAX	수입세
ITBINVO	수입세금계산서
IMPQUTA	수입수량제한
IMPLCNS	수입승인
APIMLCN	수입승인신청
IMPDEC	수입신고
RJIMDEC	수입신고각하
EIDECLR	수입신고생략
AMIMDEC	수입신고정정
CEIMDEC	수입신고필증
IMPORTRST	수입실적
IRTB	수입업
IFPUBLC	수입외국간행물
MIREQUM	수입요건구비
IMPLNDMCMST	수입육상마스터적하목록
IMPLNDCMST	수입육상적하목록
IMPLNDHCMST	수입육상하우스적하목록
RNSM	수입인지
IMPR	수입자
REITPRT	수입제한품목
CERIMPT	수입증명서
IMPRECM	수입추천
IMPTCRN	수입통관
IMCLSYS	수입통관시스템
IMEXPRT	수입통관전문직원
ICPRODR	수입통관절차
IMRTS	수입품
IMPAIRMCMST	수입항공마스터적하목록
IMPAIRCMST	수입항공적하목록
IMPAIRHCMST	수입항공하우스적하목록
IMPSEAMCMST	수입해상마스터적하목록
IMPSEACMST	수입해상적하목록
IMPSEAHCMST	수입해상하우스적하목록
TRSTREP	수입화물대도
LETGRNT	수입화물선취보증서
HWRK	수작업
UPDT	수정
AMDECL	수정신고
UPDDE	수정일
UPDUSR	수정자
AFTUPD	수정후
TREEKND	수종
RCVORD	수주
LEVEL	수준
UNDW	수중
VPIMG	수증기영상
BALC	수지
VERTCL	수직
QLTWTR	수질
WLTTS	수질오염물질
WVCLT	수질오염방지시설
COLCT	수집
CLCTR	수집가
WPYHS	수처리제
PKTBUK	수첩
WTPN	수초
XPORT	수출
EXCNOTE	수출계약서
EXCOURY	수출국
PIEXPRT	수출금지품목
OCEXPRT	수출담당자
EGINSPC	수출물품검사
EFEPERM	수출승인면제
ISEPERM	수출승인물품
EXLCFRM	수출승인서
EXPDECL	수출신고
RJEXDEC	수출신고각하
EEDECLR	수출신고오류
AEDECL	수출신고정정
CEDECL	수출신고취하
ECINSUR	수출신용보험
XPORTACT	수출실적
EXREQM	수출요건
RMEXPRT	수출용원자재
EXPLNDMCMST	수출육상마스터적하목록
EXPLNDCMST	수출육상적하목록
EXPLNDHCMST	수출육상하우스적하목록
IMXPRT	수출입
PNIMEXR	수출입공고
SIMEXRT	수출입관련견품
IMXCNR	수출입국
PIEXIMR	수출입금지품목
EPNIEXP	수출입별도공고
IMXPRTDEC	수출입신고
EIIEDEC	수출입신고오류
REGCLER	수출입의제
RIEIMPT	수출입제한품목
IECDIV	수출입통관국
DIMEXCD	수출입통관국장
IECBULD	수출입통관청사
EXPTER	수출자
VOEXRES	수출자율규제
ERECMDT	수출추천서
EXCLERN	수출통관
EXCEDIV	수출통관과
EXCLSYS	수출통관시스템
EXRTS	수출품
EXPAIRMCMST	수출항공마스터적하목록
EXPAIRCMST	수출항공적하목록
EXPAIRHCMST	수출항공하우스적하목록
EXPSEAMCMST	수출해상마스터적하목록
EXPSEACMST	수출해상적하목록
EXPSEAHCMST	수출해상하우스적하목록
ELFORM	수출허가서
RECEPT	수취
CARUL	수취대
ADDRSE	수취인
NCL	수치
NCRT	수치제작물
NRM	수치지도
MTMRL	수치지도작성
TRUST	수탁
TRPRDEL	수탁가공
TRUINSTT	수탁기관
TRUENTPR	수탁기업
TRUENTPR	수탁기업체
TRUSTEE	수탁자
IMCONSG	수탁판매수입
TRUCMPN	수탁회사
HRZNTLTY	수평
CHECK	수표
BAGG	수하물
CONSGE	수하인
MTHMC	수학
FLOO	수해
EXC	수행
ATNDDU	수행업무
ENTURG	수행원
EXMT	수험
EXNST	수험생
TRNSFS	수혈
TREETY	수형
CNVCT	수형인
CNMLS	수형인명부
CNVCT	수형자
RCVFVR	수혜
RCVFVER	수혜자
TELRCVR	수화기
RECIVR	수화자
EXPRT	숙련
ERTG	숙련도
STAYNG	숙박
LDGS	숙박업
BDRD	숙식
NHTC	숙직
NTWN	숙직수당
NHHR	숙직자
MONT	순간
PURESM	순계
PTROTMRTVR	순국선열
PRTDG	순도
SN	순번
ORDR	순서
NTSPLS	순세계잉여금
PURITY	순수
TRINSPCT	순시
NC	순원가
RANK	순위
NTPF	순이익
NTPL	순자본
NSTS	순자산
NETWGHT	순중량
NTINC	순증
NTINC	순증가
DHNH	순직
ORDR	순차
PATRL	순찰
NTNG	순톤수
PURFC	순화
ROTAT	순환
CCLSYS	순환계
CIRCL	순환기
RND	순회
ROVER	순회감시직원
RNDC	순회교육
LIQR	술
YST	술덧
HIDE	숨김
BCC	숨은참조자
NUMBER	숫자
FRT	숲
SPERCOM	슈퍼컴퓨터
THREAD	스레드
SMRT	스마트
SRTR	스마트카드
SMOG	스모그
SWPTRAN	스왑거래
SWTCH	스위치
STTV	스카우트활동
SCAN	스캔
SCHDUL	스케줄
SCORE	스코어
SCRAP	스크랩
SCRL	스크롤
SCREEN	스크린
SCRPTR	스크립터
SCRIPT	스크립트
SCHEMA	스키마
SKIGRD	스키장
SKN	스킨
SKIP	스킵
STAR	스타
STYLE	스타일
STACK	스택
STMP	스탬프
STY	스토리
STRGE	스토리지
SCKP	스톡옵션
STDIO	스튜디오
STRT	스트럭쳐
STRMG	스트리밍
STRP	스트립
STICKR	스티커
SPAM	스팸
SPECTRM	스펙트럼
SPORTS	스포츠
SPNSER	스폰서
SPOOL	스풀
SPREAD	스프레드
SLIDE	슬라이드
SLACK	슬랙
SLUDGE	슬러지
SLOT	슬롯
SLIP	슬립
HABIT	습관
HD	습도
PICKUP	습득
LOSFUND	습득물
FINDER	습득자
WETNS	습성
SMLD	습지
SWYMG	습지훼손
ASCNT	승강
ELVTR	승강기
ELVTRSAFECMPNT	승강기안전부품
PSNGER	승객
SUCCS	승계
PROMT	승급
CONFM	승낙
VICTRY	승리
CRW	승무원
CREWLST	승무원명부
EMBRK	승선
DECEMBR	승선신고
EMBKR	승선자
EMBRKAVRGWAGE	승선평균임금
EMBPERM	승선허가증
SRVEST	승역지
RDNG	승용
CONFM	승인
CERATS	승인서
CONFMER	승인자
CNFC	승인취소
PRMOT	승진
TKCAR	승차
CITY	시
HOUR	시
MKTC	시가
DRFMPRC	시가역산율
TOWN	시가지
TM	시각
VWPOINT	시각
TIME	시간
TMZON	시간대
OVTIME	시간외
OVTMWORK	시간외근무
KLK	시건
WTC	시계
TMSRES	시계열
CNSTRCT	시공
CNSTRCTSPRVISN	시공감리
CNSTRTR	시공자
CNCTC	시공참여자
SIGU	시구
SIGUN	시군
SIGNGU	시군구
SGNR	시군지역
CTYBNK	시금고
PYMHR	시급
ERA	시기
SENARIO	시나리오
DWTW	시내
DDSHOP	시내면세점
LCLN	시내전화
PRVSTL	시담
ATPT	시도
CTPRVN	시도
CTRD	시도
CDDC	시도교육청
STRTG	시동
CDROM	시디롬
VSPR	시력
SPLORE	시료
MUNIC	시립
SIMLATN	시뮬레이션
CTZN	시민
CFSMT	시민고충처리위원회
CVSCT	시민사회
CLST	시민사회단체
EXMPL	시범
TSR	시베리아횡단철도
HM	시분
HMS	시분초
DISP	시비
TIABL	시산표
PRIZE	시상
FCLTY	시설
ERNT	시설대여
EQPT	시설대여업
EQLECMP	시설대여업자
FCLTS	시설물
FLMSSM	시설물정보관리종합시스템
FCLTYCHANGE	시설변동
MPIFAC	시설재
EQNN	시설주관기관
FCLTYLIMIT	시설한계
FCLTYTRTY	시설협정
CURPRC	시세
SESAW	시소
SROPRM	시술소
SYS	시스템
LG	시스템로그
CYN	시안
MNCMNG	시영
SUBURBS	시외
DMNSTR	시위
CTYLND	시유지
TIMELINESS	시의성
BEGIN	시작
BGNDE	시작일
MRKT	시장
MTWLL	시장도매인
MRTSR	시장점유율
MAQUOTA	시장접근물량
TMIP	시장정비사업
OLGPLSTS	시장지배적사업자
PNTTM	시점
COREC	시정
MDOV	시정
TMDIFF	시차
POLICI	시책
CTYHLL	시청
AUDV	시청각
DLL	시추
LMPD	시한
BOUT	시합
OPERTN	시행
ENFDCR	시행령
TEST	시험
EXPR	시험
PLPLNT	시험공장
MHMN	시험법
LBRTRY	시험실
TSTR	시험자
EXMR	시험장
EXEQ	시험장비
EXSG	시험조사
PRSCRP	시효
IEPREPN	시효의중단
FRMLA	식
ETCH	식각
PLCHK	식검
FSTMP	식권
DIET	식단
RSTRNT	식당
CGFFD	식대
FOD	식량
FDSTFFS	식료품
PLNT	식물
NPQS	식물검역부
BGADN	식물원
IDNTFC	식별
IDNTFR	식별자
MEAL	식사
VTN	식생
DTLF	식생활
SSGM	식스시그마
APPT	식욕
EDYG	식용란
CKL	식용유
MEAT	식육
MCGS	식육가공품
FBUSNS	식음료판매업
PLT	식재
FSN	식중독
FOOD	식품
FHYG	식품위생
KFDA	식품의약품안전청
FOODADTV	식품첨가물
VCR	식피
NW	신
NERV	신경
STTEMNT	신고
RJDECL	신고각하
DCLPAY	신고납부
DPAYSYS	신고납부체제
GDDECL	신고대상물품
DCLRT	신고서
DACEPT	신고수리
ERORDEC	신고오류
APLCNT	신고인
APLCNT	신고자
RDAT	신고지연가산세
DECCANL	신고취하
CERDECL	신고필증
NRNRC	신공항건설사업
FUSE	신관
NWD	신구
NEW	신규
NEWCHMCLS	신규화학물질
NTCNQ	신기술
FCWHL	신기술사업금융업
NTHY	신기술사업자
NEWYEA	신년
SYNDCT	신디케이트
CNFDNC	신뢰
RLABLTY	신뢰성
RCGRLB	신뢰성인증
QUEINTV	신문
NWSPR	신문
NSPRC	신문사
FTWR	신발
BODSRCH	신변검사
BSCHROM	신변검색실
PEREFCT	신변용품
PERORNM	신변장식용품
RUKI	신병
SCLPST	신분
EMERG	신생
NWNBB	신생아
LETR	신서
NCR	신설
NCPN	신설회사
RPD	신속
WRRG	신약
CREDT	신용
CRDTD	신용거래
CRFFR	신용공여
CRSECRT	신용담보
CRDASR	신용보증
CDR	신용보험
LETCRDT	신용장
APPLCLC	신용장개설의뢰인
CREDTINFO	신용정보
CNMBS	신용정보업
CIBIZER	신용정보업자
CFNFTT	신용정보집중기관
CREDTEXAMINJOB	신용조사업무
CRDINQR	신용조회
CREDTINQIREJOB	신용조회업무
CREDTCARD	신용카드
CDRSR	신용카드가맹점
CTRBS	신용카드업
CREDTCARDBSMN	신용카드업자
CREDTCARDMBER	신용카드회원
CDLT	신용평가
CFESTBIZ	신용평가업무
IDNTY	신원
CNFDN	신임
NWMB	신입
HEIGHT	신장
NHPD	신조선
NKNND	신종사채
NSTK	신주
WRANT	신주인수권
BWHN	신주인수권부사채
CRNS	신주인수권증서
REQST	신청
APRSLT	신청결과
REQSTDOC	신청서
RQFRM	신청서식
RQSTDT	신청연월일
APPLCNT	신청인
RQSTDT	신청일
APPLCNT	신청자
BDY	신체
NWCC	신축
TRST	신탁
TRUBIZ	신탁업
TRSTER	신탁자
NHBR	신항만
NNTRB	신항만건설사업
NTYL	신형
SIGNL	신호
SGNGNR	신호기
TFCLGHT	신호등
SGNL	신호링크
SGNSTT	신호소
SIGNAL	신호표지
SGNASP	신호현시
RL	실
SIL	실
FRRSC	실권주
PRCTTQ	실기
INDOOR	실내
EXPLE	실례
CYLNDR	실린더
LSFT	실명
RLNM	실명
RLNMCV	실명전환
PRCAFS	실무
BMT	실무위원회
OBJT	실물
RLTHNG	실물
ACEXP	실비
AEACOST	실비상당액
ACINS	실사
SUBSTNC	실속
SBSTY	실속형
MSTK	실수
RLNO	실수
ENDS	실수요자
PRCTICE	실습
OPRTN	실시
RLTM	실시간
FNT	실신
UNEMPL	실업
VCSCHL	실업계
UNEMPRCG	실업인정
OTDR	실외
UTLMDL	실용신안
UTLMDLRT	실용신안권
SCCHF	실장
ACMSLT	실적
NCNTR	실전
ACTCON	실정
REAL	실제
AMVLUE	실제시장가격
MSS	실종
DCLDSP	실종선고
ABSCNDR	실종자
ACTU	실지
ACTLHNM	실지명의
AUDTSPT	실지심사
MTRINJR	실질적피해
ENTTY	실체
ACMSR	실측
ACCDT	실태
FAILR	실패
RW	실폭도로
EXECUT	실행
APDURTE	실행관세율
EXCTN	실행자
EXPER	실험
LFTRY	실험실공장
RELIZE	실현
AFIRE	실화
EFCTV	실효
SERIUS	심각
TIADCS	심결
DPH	심도
TRL	심리
PSCHWR	심리전
INTERGT	심문
SYMBOL	심벌
SYMBOL	심볼
JDGMN	심사
AUDOFIC	심사관실
AUDIVSN	심사국
TRGINSP	심사대상업체
AUDTEM	심사반
AOHOFIC	심사본청담당자
JUDGE	심사위원
JDGCMIT	심사위원회
AUDOFIR	심사자
ADCNKIS	심사정보관리운영담당자
AIANAYS	심사정보분석
CFAUTEM	심사주무
EXAMREQ	심사청구
AMSECTN	심사총괄과
SAMSEC	심사총괄과장
AUDADIM	심사행정
MNTL	심성
MDBY	심신
MDGHT	심야
MDGHTDSCNT	심야할인
DLBRT	심의
DLTNC	심의회
HEART	심장
ELECGRM	심전도
DEPTHS	심층
REFREEE	심판
ADJREQ	심판청구
CDPMRSCT	심폐소생술
DPL	심해저
CRDVSC	심혈관
TE	십
FGTLL	싸움소
FGLST	싸움소주인
RICE	쌀
BLTR	쌍무
BLTRCNTRCT	쌍무계약
BLTRL	쌍무적
BCTARF	쌍무협정관세
TWNENGN	쌍발
RRSTB	쌍방대리
TOWWAY	쌍방향
SLDPL	썰매장
THUMB	썸네일
TRASH	쓰레기
THREAD	쓰레드
GLUE	아교
ANLG	아날로그
CHIL	아동
LWDRC	아래쪽
BCAP	아름다운관세행정파트너
FATHR	아버지
_ASEAN	아세안
APNRT	아스콘
ASIA	아시아
ZINC	아연
OUT	아웃
OUTBND	아웃바운드
OUTSRCNG	아웃소싱
ID	아이디
IDEA	아이디어
ICON	아이콘
ITM	아이템
IP	아이피
MORN	아침
ACCA	아카시아
ARCHV	아카이브
ARCHTC	아키텍처
ATACRT	아타카르네
ARTST	아티스트
APT	아파트
APTPFTR	아파트형공장
OPIUM	아편
AFRICA	아프리카
SBH	아흉고
MCLSR	악기
ORCHS	악단
MCSC	악성코드
MLGNPGM	악성프로그램
BSML	악취
BMCFT	악취배출시설
LNNG	안감
FG	안개
FGIMG	안개영상
MTR	안건
GLSS	안경
OTHMG	안과
GUIDANCE	안내
GDCC	안내문
ANNNC	안내방송
INFBRU	안내소
DRCBRD	안내판
PIGMNT	안료
SECRTY	안보
SESUVIG	안보감시
PRPDVS	안분
SAFETY	안심
SFTMN	안심자
OMRGY	안이비인후과
BURIAL	안장
SAFE	안전
SFMNG	안전관리
SFTBLT	안전띠
SFHDGNS	안전보건진단
SFEQIP	안전설비
SFINSTPK	안전용기포장
SFCRT	안전인증
EPSFS	안전인증대상전기용품
SFINVC	안전재고
SAFECHK	안전점검
SFZONE	안전지대
SFLBL	안전표지
STABLE	안정
STBLE	안정화
PLACMNT	안치
ANTN	안테나
ENTGS	알가공품
ALGRTH	알고리즘
ALLRGY	알레르기
ALMNM	알루미늄
NTCN	알림
RCMNDTN	알선
ALCHL	알코올
ALCHL	알콜
CANCER	암
UNDDRN	암거
_NH3	암모니아
ROK	암석
CANCERCNTER	암센터
HINT	암시
PASSWORD	암호
PSWDMTR	암호자재
ENCPT	암호화
PRESSR	압력
PRSRCNTN	압력용기
SEIZR	압류
SZRPBT	압류금지
SZR	압류자
DSTRNR	압류채권자
OPRSS	압박
SZURE	압수
CCDRC	압수물
SEZWRNT	압수영장
CNSK	압수표
SEIAC	압수품
ORSMBR	압제번호
CMPRS	압축
CPSDG	압축가스
PRSOUT	압출
PRE	앞
BRFTR	앞뒤
PETDOG	애견
PATRTSM	애국
PATRT	애국지사
ANM	애니메이션
BTLN	애로
_AS	애프터서비스
APLCTN	애플리케이션
AM	액
FVAL	액면
PVSTOCK	액면주식
LIQD	액상
ACSRY	액세서리
ACCES	액세스
LIQID	액체
LQDTL	액체물질
LQDEXP	액체폭약
LQFS	액화가스
LFTLS	액화석유가스
LRPCN	액화석유가스저장자
LYPYN	액화석유가스집단공급사업자
LDRHS	액화석유가스충전사업자
LPGSELER	액화석유가스판매사업자
ALBUM	앨범
APP	앱
NIGHT	야간
BBPRK	야구장
NGTWR	야근
YRDTRA	야드트랙터
YABA	야바
WLDNS	야생
WLPNT	야생동식물
WDFW	야생화
CMP	야영
CAMPG	야영장
FELD	야외
PCNPL	야유회장
OASTRG	야적
OASYARD	야적장
STPLAT	약관
PARMACY	약국
OTLNMAP	약도
PARMDYNAMCS	약동학
PARMDYNAMC	약력학
PARMACLG	약리
MFRS	약무
DRFSTF	약물
DDGNC	약물상호작용
PARMGEN	약물유전체
PARMACST	약사
PROMS	약속
PRMSNT	약속어음
INFRML	약식
SYDR	약식명령
SHRFRBL	약식선하증권
ABRV	약어
MCLLT	약용식물
MDCRP	약용작물
WKSN	약자
MDNTF	약재
ENGG	약정
AGINST	약정이자
MEDCIN	약제
ABRV	약칭
MEDCIN	약품
DRLC	약해
CDDR	약호
RMDRSLT	약효
QY	양
GRAIN	양곡
GBYD	양곡매매업자
GRNBS	양곡증권
POPPY	양귀비
TRNSFR	양도
TRFSCR	양도담보
PTRSECU	양도담보재산
TRFENS	양도배서
TRFINCTAX	양도소득세
ASGNR	양도인
SLRCLD	양력
TKCRAGE	양로
UNLDNG	양륙
PNTDSCH	양륙지
PODIS	양륙항
BDRCL	양방향
JPPROV	양벌규정
BKP	양봉
MSPDC	양산
TRNNG	양성
INHRTN	양수
WP	양수
WRMP	양수기
GRNTE	양수인
ASNE	양수자
FORM	양식
RAISNG	양식
FRMT	양식화
FSHFRM	양어장
SNDAMT	양여금
BRP	양육
OSDPORT	양육항선택할증료
BOTH	양자
BILTCUM	양자간누적
CANDLE	양초
ADRTCH	양친자
LANDNG	양하
UNDSTND	양해
MRDN	양해각서
CDRATE	양허관세율
CNESDUT	양허세율
GOOD	양호
FHRSHS	어가
FBD	어골도
SHLDR	어깨
ADPTR	어댑터
FSHWY	어도
DRKN	어둠
WHERE	어디서
HOW	어떻게
FSHRY	어로
FISHES	어류
CHILD	어린이
CHILDPRTCPACKNG	어린이보호포장
CHRK	어린이주간
CHLDSBUS	어린이통학버스
PFWSL	어문규범
FSHRBT	어선
FSHRBTOWNER	어선소유자
CEW	어선원
VSLDSS	어선재해
ASSMBLY	어셈블리
FSHR	어업
FYHTS	어업권
FHCTRC	어업생산통계조사
FHSTM	어업용시설
FSHRMN	어업인
FSHRM	어업자
FSHRDSSTR	어업재해
FSHRN	어업종사자
FSPVS	어업지도선
FSHERY	어업활동
BIL	어음
BCTLACT	어음관리계좌
BLLCL	어음교환
LNBLS	어음대부
BILTRNSCR	어음등본
BILPRSCRP	어음시효
FSHL	어장
FPCMN	어장정화정비
FCRFT	어장정화정비업
FLCCS	어장휴식
KDFSH	어종
FHLG	어촌
CNSPJ	어촌종합개발사업
APLCTN	어플리케이션
AA	어플리케이션아키텍처
LSTCS	어학
FST	어항
FHPDPR	어항개발사업
FSPT	어항구역
FPFC	어항시설
FHRM	어항운영전산망
CHFFSH	어획
FTNTBS	어획물운반업
FTSMN	어획물운반업자
FHYBRS	어획물운반업종사자
VCBLR	어휘
DETNT	억류
SPRCR	억압반송파
RESTRN	억제
DTRNC	억지
MENTN	언급
HILL	언덕
OSPBHV	언동
MSCMNC	언론
MSCMNC	언론기관
MSMDA	언론매체
MMNWS	언론보도
MSMCPT	언론분쟁
OXPR	언론사
ORXRV	언론사대표자
LANG	언어
WHEN	언제
FACE	얼굴
STI	얼룩
STRICT	엄밀
BCS	업계
UPGRAD	업그레이드
UPLOAD	업로드
UPLMN	업로드자
UPLINK	업링크
JOB	업무
BR	업무규칙
JOBBY	업무별
DTNCFT	업무상재해
BA	업무아키텍처
BPR	업무재설계
DTMN	업무편람
BBM	업무표장
BSSH	업소
BSMN	업자
ACHV	업적
INDUTY	업종
ENTRPS	업체
BIZCND	업태
EGMGRUP	에그몽그룹
ENERGY	에너지
ENERGYSUPLYEQP	에너지공급설비
ENERGYSUPLER	에너지공급자
EGYY	에너지사용기자재
ERPST	에너지사용시설
EYR	에너지사용자
DSCNT	에누리
EDITR	에디터
ERROR	에러
ESCLTR	에스컬레이터
ARDCPL	에어로빅장
AIRBAG	에어백
ARCNDTN	에어컨
AIDS	에이즈
CHCH	에틸벤젠
EXCEL	엑셀
XCNTS	엑스
XCNTS	엑스좌표
ACTTR	엑츄에이터
EML	엔드밀
ENGER	엔지니어링
ENGERTCHNLGY	엔지니어링기술
ENGERBSNS	엔지니어링사업
ENNY	엔지니어링활동
ENGINE	엔진
ENTITY	엔터티
ENTITY	엔티티
ELN?	엘니뇨
ELVTR	엘리베이터
LSR	여가
PASNGR	여객
PASGLST	여객명부
PSNSHIP	여객선
PSNGFAC	여객시설
PTRANSVC	여객자동차운송사업
PTSVC	여객자동차운수사업
PVTRML	여객자동차터미널
PVTRMLBIZ	여객자동차터미널사업
CND	여건
FILTER	여과기
PASPORT	여권
PSPRNBR	여권번호
RLPRTY	여당
PBLOPN	여론
ONVY	여론조사
SUMMER	여름
BLANK	여백
BACKUP	여벌받기
AT	여부
EXTRA	여분
TRVCT	여비
FEMALE	여성
BSWMN	여성경제인
FTSLY	여성과학기술인
FTFWN	여성관련시설
FNRSS	여성기업
WNNRS	여성농어업인
FLYGR	여성농어업인관련시설
OGZRCR	여성농어업인단체
FEMALEFRMER	여성농업인
WMGNZ	여성단체
MOGE	여성부
WFHY	여성어업인
PCYWMN	여성정책
CDTLN	여신
GVRD	여신금융기관
SLCNN	여신전문금융업
SLDDP	여신전문금융회사
MRGN	여유
INN	여인숙
FEMALE	여자
GRLSTDN	여학생
TOUR	여행
PASSNGR	여행자
PIASECT	여행자정보분석과
APIS	여행자정보사전확인제도
CPDFRM	여행자휴대품신고서
FMHDM	여호주
STATN	역
DTCHAC	역경매
REVENGR	역공학
INTRA	역내
ORGMTER	역내물품
TWFTZNE	역내양도
ABILITY	역량
SVC	역무
BCKWR	역방향
RVSWIR	역배선
CVRRY	역배열
SCN	역사
DEUPRCE	역산가격
OFSHR	역외
PQFTZNE	역외가공
TRNSLR	역자
INVRS	역전
FOCUS	역점
MLTDTCS	역종
EPDM	역학
EPDMIV	역학조사
ROLE	역할
FYER	연간
YRBK	연감
CNNC	연결
CNNCCAR	연결자동차
CBY	연경
CNTC	연계
LNKTRDE	연계무역
BALM	연고
RLATIV	연고자
RLZONE	연고지
RELATE	연관
RSRCH	연구
RCHFS	연구교수
RRCS	연구기관
RSRCCT	연구비
INSTLM	연구소
RNTMP	연구소기업
LABRUM	연구실
RSRCHR	연구원
RSLSN	연구활동종사자
SCTRSR	연구회
RRV	연구휴가
PLAY	연극
ANNTY	연금
PSTPONE	연기
TXPOST	연납
SLDRTY	연대
JNGRT	연대보증
JTDB	연대채무
YEAR	연도
INTRLCK	연동
LNKG	연동장치
CONTACT	연락
CNTCTR	연락자
CTTPC	연락처
AGE	연령
AGRDE	연령대
FUEL	연료
BAFCTR	연료비할증
FLOIL	연료유
FCLVHL	연료전지자동차
RWHS	연립주택
TRAINNG	연마
SMSC	연막
THMFOG	연막소독
YND	연말
TOTAR	연면적
POND	연못
FDR	연방
SN	연번
ANLRPT	연보
ANSLRY	연봉
YRINS	연부
DEFRPAY	연불
DRYR	연불수출
SSDFDY	연불판매
MILEG	연비
CALC	연산
CLTHD	연산식
OPRTOR	연산자
JNTPRDT	연산품
JLNNC	연생보험
KERB	연석
SPEECH	연설
DTTSC	연설문
CMBS	연소
MBRR	연소근로자
CMBST	연소성
YUTH	연소자
CTNU	연속
SDYTRN	연수
PRCER	연수생
TNINST	연수원
PRCT	연습
YRIDNW	연식
COAST	연안
COASTWATERS	연안수역
CSPLN	연안습지
COASTIMPRMNBSNS	연안정비사업
CSSR	연안해역
ENTRTN	연예
YM	연월
REASN	연유
REAPNT	연임
ET	연장
EXTN	연장
EDBF	연장전
EDR	연장후
PLAYNG	연주
WHLYR	연중
YRYC	연차
HSTY	연찬
ARRRG	연체
ARRS	연체료
OVDINTR	연체이자
DIRC	연출
BRFS	연탄
BMTND	연탄제조업
YRYMN	연평균
TRM	연한
UNION	연합
ALNTNS	연합국
HIST	연혁
YYF	연회비
COLUMN	열
READNG	열람
LBCE	열람석
READR	열람자
_CAL	열랑
HTDWR	열사용기자재
HPDCR	열생산자
KEY	열쇠
LIN	열수
TRAIN	열차
SALT	염
DYEING	염색
CHLOR	염소
SLTPAN	염전
SALMNF	염제조업자
CACL2	염화칼슘
CIGAR	엽궐련
ZR	영
TRTAIR	영공
PRMANENT	영구
PRMDSPS	영구처분
YNAM	영남
FARM	영농
FSZ	영농규모
PRFTMK	영리
PRFMINSR	영리보험
FSMPN	영림계획
FTRC	영림기술자
ENG	영문
CONSUL	영사
CNSLAT	영사관
PJCT	영사기
CSUINVO	영사송장
VIDO	영상
VDSK	영상디스크
VLDT	영상물
VLNRY	영상산업
MNTNNC	영선
POOR	영세
TPR	영세민
SSEXPTR	영세수출자
ZRPCTAX	영세율
RCPT	영수
RCPTER	영수인
RCIPT	영수증
NTTPAY	영수필통지
ZRH	영시
BABY	영아
MORT	영안실
NTR	영양
NTRIMPRVM	영양개선
NTRST	영양사
NDS	영양진단
ENGL	영어
BSN	영업
BSNLCNS	영업면허
BSNSECRET	영업비밀
BSNSECRETINFRACTION	영업비밀침해행위
BUZPLC	영업소
BSNTRNSFR	영업양도
BUZPLC	영업장
RELM	영역
HONR	영예
MANAGET	영위
INFANT	영유아
WRRANT	영장
PRIMAT	영장류
GENIUS	영재
SDTFD	영재교육
BLNRSF	영재교육기관
SLFDC	영재교육연구원
BTCSH	영재학교
BTLSS	영재학급
HONORS	영전
ZEROPT	영점
RCPTN	영접
PBLWRK	영조물
PRMRSD	영주
DNZNSHP	영주권
CSDY	영치
CSDNY	영치금
CYYG	영치금품
CSDS	영치품
TRTRY	영토
TRTSEA	영해
AFFC	영향
IPCSS	영향평가
SPRWRDED	영현
MOVIE	영화
PRDPRC	예가
STTBDG	예결
PRVNTC	예고
RTVTC	예고등기
ELSH	예규
TEMP	예규임시저장
DPST	예금
DPSTR	예금자
DPSTR	예금주
DSTT	예금증서
DSTCLM	예금채권
BNKBK	예금통장
ADVNPAY	예납
ATLS	예능
ADVANTK	예매
PREVNT	예방
VACNTN	예방접종
FRCST	예보
WTHMN	예보관
FRCSTBSNM	예보사업자
FRCSTD	예보자료
PREPAR	예비
RSVFRC	예비군
RRMYPR	예비군육성
RRCPT	예비군지원
PRREGST	예비등기
RSVFND	예비비
PRMPAYR	예비지급인
BUDGET	예산
BDGTPR	예산서
AFTAPVBGT	예산성립후
TRSFBGT	예산이용
EXPECT	예상
ACOPTOC	예상운전과도
TGBOAT	예선
TGBOTCTC	예선계약
SBORDIN	예속
ADVRCV	예수
ART	예술
EX	예시
ETBLFM	예식
RESVE	예약
RSVDE	예약일
RSVCTM	예약자
EXCP	예외
HLRT	예우
MKST	예입
ETBLFM	예전
PRPRT	예절
PREARNGE	예정
PLNPRC	예정가격
PRSINSR	예정보험
PRARNDE	예정일
PREARNGER	예정자
INTSPT	예정지
PARAR	예정지역
TLSCDL	예정회담
PREM	예지
PREDICTN	예찰
PREDICT	예측
DPST	예치
DSMN	예치금
SLPDEPS	예치증
DEPDESK	예치품접수
DPSTG	예탁
DPMNY	예탁금
KCTTY	예탁원
RHRSAL	예행
OLD	옛
FI	오
MSBS	오남용
FLTPAY	오납
OWNER	오너
ICRCT	오답
ICTNS	오답자
ORDER	오더
AUDIO	오디오
RCRT	오락
ERROR	오류
ERBBS	오류신고게시판
UPHIL	오르막
RGHT	오른쪽
ORIENTATN	오리엔테이션
ORIENT	오리엔트
DSGRC	오명
DIRT	오물
OVER	오버
OVFLOW	오버플로우
FSPRT	오보
OBJECT	오브젝트
OSANAIR	오산공항
MCCARG	오송화물
PLTWTR	오수
STTY	오수처리시설
POLLUTN	오염
PNLV	오염도
CNTMNNT	오염물질
PLULOD	오염부하량
PLUWSH	오염세탁물
POLTNSRC	오염원
MISUSE	오용
MSCNP	오인
_AM	오전
OZ	오존
OZLAYER	오존층
UPCNTRY	오지
EROR	오차
ABYL	오토바이
OFER	오퍼
OPRTIN	오퍼레이션
ACEPTN	오퍼수락
OFLNE	오프라인
OFFST	오프셋
OTCNTNR	오픈톱컨테이너
OFCTL	오피스텔
_PM	오후
INSDHOUS	옥내
RF	옥상
OUTHOUS	옥외
OUTADVTS	옥외광고물
ONRSS	옥외광고업
OPRMT	옥외집회
TP	온도
THRMT	온도계
ONLINE	온라인
ODTNS	온라인디지털콘텐츠
OLTMN	온라인디지털콘텐츠사업자
ODLSY	온라인디지털콘텐츠산업
OLNNF	온라인디지털콘텐츠제작
ONGTT	온라인디지털콘텐츠제작자
ONVR	온라인서비스제공자
GRNH	온실
GGSS	온실가스
GHSS	온실기체
HSPR	온천
ONTO	온톨로지
UPLOAD	올리기
OMBDSMN	옴부즈만
OPTN	옵션
OPTION	옵션
OPTION	옵션거래
OPTMZR	옵티마이저
BREWAL	옹벽
YDNTS	와이
YDNTS	와이좌표
EDYNT	와전류
COMPET	완공
TOY	완구
BRVN	완급차
FPY	완납
COMPT	완료
CMPTER	완료자
CMPLTN	완비
CMPLT	완성
ARMBAND	완장
PRFECT	완전
FULCUML	완전누적
CKDGOD	완전미조립물품
SCP	완전생산기준
PBILL	완전어음
FLFTCM	완전자회사
FPY	완제
EDCTS	완제품
EASING	완화
ECV	완화곡선
INTRCRS	왕래
RCPMOT	왕복운동
WHY	왜
DSTOR	왜곡
_ELSE	외
SURG	외과
APPRNC	외관
DPLM	외교
DSDIPL	외교관면세매점
DPLMDC	외교문서
MOFAT	외교통상부
DPLPUCH	외교행낭
FRNTN	외국
FPBCS	외국간행물
FRGLEGT	외국공사관
FRGSC	외국교육기관
FRGEMBS	외국대사관
FKYC	외국도산절차
FNRN	외국명
FNCN	외국무역기
FGNS	외국무역선
FGNG	외국물품
FNVSN	외국민간원조단체
FRNP	외국법인
FNNCN	외국보험회사
FNSHP	외국선박
FGGG	외국어
FGCST	외국연구기관
FRGNR	외국인
TRIGOD	외국인내국세면세물품
FGNRNO	외국인등록번호
FRGCR	외국인보호소
FRGNRPRTC	외국인보호실
FDINVST	외국인직접투자
FGVST	외국인투자
FNSY	외국인투자기업
CCOFINV	외국인투자기업통관상담실
FIPACT	외국인투자촉진법
FGNRRC	외국통화
FGVS	외국투자가
FRRTD	외국학교법인
FNCHG	외국환
FETACT	외국환거래법
EXRTSEL	외국환매도율
DCFEXCH	외국환신고대
DSFEXCH	외국환신고필증
FGNGS	외국환업무
OUTDT	외근
FRGN	외래
FK	외래키
OPATIENT	외래환자
LOOK	외모
FRGSRV	외무공무원
EXTW	외벽
EXTRL	외부
NOTI	외부고시
EXTAFR	외사
CRDT	외상
OBSC	외설
FRGCPT	외자
EXTRR	외장
EXTRRCNTNR	외장용기
MTRPRNT	외조부모
OUTORD	외주
GNOT	외출
RIND	외피
ENCLBX	외함
OCGSH	외항선
FGCRY	외화
FRGCREG	외화등록
CSFCUR	외화외상매출
FGYRY	외화증권
FNBD	외화채권
FRXCG	외환
HOFISEC	외환검사본청담당자
FNINSEC	외환조사과
LEFT	왼쪽
RQISIT	요건
RAS	요건승인시스템
REQVERF	요건확인
DEMAND	요구
DMDDOC	요구서
DMNDR	요구자
RSCDMD	요구조자
CHRGE	요금
CRGLT	요금계산
FRCH	요금면제
CQRYB	요금문의
TRFF	요금표
CHEAT	요령
URSTM	요루
THERPY	요법
FACTOR	요소
FMLPR	요식증권
SUMRY	요약
RCPER	요양
HPTL	요양기관
CCTY	요업
STAFF	요원
TARIFF	요율
FCTR	요인
FCTRSCRITS	요인증권
ATENT	요주의
OUTLINE	요지
UNEVN	요철
REQUST	요청
REQUSTCTR	요청국
RQESTDE	요청일
RQESTER	요청자
DESIRE	욕구
ABSE	욕설
BTR	욕실
CNTNR	용기
IRNS	용기가스소비자
ISRT	용기집합설비
CGKG	용기포장
DLVSRV	용달
CRSSL	용대선
PRPOS	용도
USGAR	용도구역
SUDRATE	용도세율
UOTHPUR	용도외사용
SPCFC	용도지구
SPFC	용도지역
CPCTY	용량
CNTENC	용모
BUSINS	용무
USAGE	용법
CHATR	용선
CTRY	용선계약
CHRTBL	용선계약선하증권
CHTRG	용선료
CHRTER	용선선사
USWTR	용수
RSRVR	용수지
SPRI	용수철
WORD	용어
SERVC	용역
SVST	용역원가
SCCNS	용역위탁
SUSPCT	용의자
EASE	용이
TOLRULE	용인기준
MEASRMT	용적
CPCTY	용적
CLMWGH	용적중량증명서
MEASTON	용적톤
WSR	용접용기
SHET	용지
SUPLI	용품
MLTG	용해
SLBL	용해성
RIT	우
PVLTRT	우대
EXCLLNC	우량
WORRY	우려
URGRUND	우루과이라운드
KOREA	우리나라
ELCWRH	우리사주
ESWRS	우리사주조합
OXNHRS	우마
WELL	우물
LTTRM	우범
PRFTECH	우범성판별기법
PLTCC	우범자
UMBRLA	우산
PRIOR	우선
PRIO	우선권
PRIPAY	우선변제
PRIORT	우선순위
PRSTK	우선주
EXCLNC	우수
ELCMG	우수농산물관리
SRYR	우수선수
SDR	우수지도자
RHTBNK	우안
MILK	우유
DKPAR	우점종
PSTAFS	우정
PSTSVC	우정사업
PSTSVORG	우정사업조직
UNIVRS	우주
SPCMNSHP	우주개발
UVSDVWRK	우주개발사업
NRNDTR	우주국
STBC	우주물체
UVSACD	우주사고
PSTOFC	우체국
POINSR	우체국보험
PODPS	우체국예금
RGHT	우측
POST	우편
PSTMTR	우편물
POCCLE	우편물통관출장소
ZIP	우편번호
PSTRECP	우편소포수취증
MALTRAN	우편송금환
POSTGE	우편요금
PSTORD	우편환
PSTSTMP	우표
PSTSTMC	우표류
RNDABT	우회
CLDHG	운고
MVM	운동
SPORTS	운동
PLGRND	운동장
AMTCLD	운량
CNVYNC	운반
CRER	운반선
TRSPBIZ	운반업
LUCK	운세
TRNSPRT	운송
CRCRG	운송계약
TRTINSR	운송보험
CIPD	운송비보험료지급가격
CPDT	운송비지급가격
TRANDOC	운송서류
TRTCLS	운송약관
CRRER	운송인
WAYBIL	운송장
FRWRDR	운송주선인
TRNCMP	운송회사
TRANSPRT	운수
CARER	운수업자
DDPS	운수종사자
OPER	운영
ORPNS	운영비용
OPERERN	운영수익
OPRTR	운영인
OPRTR	운영자
OPRSUR	운영자원
OPERSYSM	운영체제
OPRATN	운용
OPERTR	운용자
CYCHG	운임
CIF	운임보험료포함가격
FGHTON	운임톤
DRV	운전
DRVSCRTYDEVICE	운전보안장치
DRVACDNT	운전사고
DRVER	운전자
DVSL	운전장애
DRVLMTTCND	운전제한조건
CANAL	운하
NVG	운항
WTORCMP	운항선사
INSVC	운항중
OPRAT	운행
OPRY	운행계통
ORBL	운행장애
CLDFRM	운형
SRVSPN	운휴
US	울산
US	울산광역시
USNAMGU	울산광역시남구
USDONGGU	울산광역시동구
USBUKGU	울산광역시북구
ULJU	울산광역시울주군
USJUNGGU	울산광역시중구
FENCE	울타리
WORKSHP	워크숍
WRKSTN	워크스테이션
WRKOUT	워크아웃
WRKFLOW	워크플로우
WON	원
PRMPC	원가
CTCNTR	원가관리
PRMCTTGT	원가대상
CMHD	원가법
LDSTC	원거리
REMOTE	원격
RMNST	원격시험장치
RLDG	원격영상심판
RTRRS	원격영상재판
RMCTRL	원격조정기
SCCLER	원격지통관
RTDT	원격직업교육훈련
TLCOMM	원격통신
RMTN	원격훈련
ACUSR	원고
MNSCRT	원고
PRNCPAL	원금
NTPRT	원내교섭단체
PRMMVR	원동기
MCBCC	원동기장치자전거
MTRAL	원료
RWMTR	원료물질
RWMATRAGNT	원료물질취급자
PNINT	원리금
ORGINL	원문
ORGINL	원본
LEDGER	원부
BNSMN	원사업자
ORGPLCE	원산지
RUORG	원산지규정
MDCORG	원산지오인표시
CERTORG	원산지증명서
MCCORG	원산지증명서확인자료
ORION	원산지판정
DECON	원산지표시
FDCORG	원산지허위표시
ORICON	원산지확인
COCERFT	원산지확인기준
TWOSTAE	원상변형작업
UNDONG	원상복구
EOGSTAE	원상태수출
EGOSTAE	원상태수출물품
RECOVRY	원상회복
DTYRY	원상회복의무
ONSUMUT	원소스멀티유즈
ORGWATR	원수
RAW	원시
SRCLANG	원어
GARDN	원예
GNDT	원예작물
CDL	원유
CRDL	원유
CAUSE	원인
NRGY	원자력
NCPWGN	원자력발전
AMYDN	원자력사고
AMGBSM	원자력사업자
ANMG	원자력손해
AMCGQP	원자력시설
ACRYP	원자력이용시설
NLRT	원자로
NCSSY	원자로냉각재압력경계
RWMATR	원자재
LEDGR	원장
RAWMTRL	원재료
IBRMETR	원재료수불대장
PRMABOD	원적
NCPWGN	원전
TRGNPT	원점
UNDCHM	원제
ASITNC	원조
SRC	원천
WHTAX	원천세
ORGNPL	원천지
WTHTX	원천징수
WHTAX	원천징수세
PRNCPL	원칙
DSC	원판
OFM	원형
RRPNT	원호대상자
WON	원화
MT	월
MNTHNG	월간
WOLG	월계
MXY	월고정급
MNTSLR	월급
PSWNTR	월동
_WEB	월드와이드웹
OVRFLW	월류
PPWTROVDPS	월류턱
ENMT	월말
MNBY	월별
MTHPR	월보
MTHT	월세
MON	월요일
MD	월일
MNRCT	월정
INMON	월중
MTYVC	월차
MTYVC	월차유급휴가
BTMNT	월초
WREHOUS	웨어하우스
WVE	웨이브
_WEB	웹
WBSR	웹브라우저
WEBS	웹서버
WSRV	웹서비스
WEBZN	웹진
EMRGNC	위급
CRISIS	위기
CYYS	위기청소년
LA	위도
POWR	위력
MMRAL	위령
MRLTW	위령탑
CONSLAT	위문
VIOLT	위반
OFFND	위반자
VIOLT	위배
ILGLT	위법
IGDV	위법배당
IGLS	위법처분
ABADOMT	위부
PHASE	위상
SNITAT	위생
HCSSV	위생관리용역업
HYGNST	위생사
HGBS	위생업무
SATLIT	위성
STLOBT	위성궤도
STLNTW	위성망
STLINFO	위성정보
_GPS	위성항법장치
CTGRL	위안부
GASFLU	위액
BKPMS	위약
PENLTY	위약금
FEAT	위업
MFCMM	위원
CHARMN	위원장
CMIT	위원회
MNDT	위임
TRUINST	위임기관
DGTRR	위임명령
MNDTENDRS	위임배서
MNDTR	위임자
LTDLG	위임장
CTLS	위자료
CMFLG	위장
WIDG	위젯
FRGRY	위조
UPDRC	위쪽
ENTRST	위촉
LC	위치
LBVC	위치기반서비스사업
LCINFO	위치정보
LCINFOBSNS	위치정보사업
LCINFOSYS	위치정보시스템
WIKI	위키
CNSGN	위탁
TRPRCMS	위탁가공무역
TRUINSP	위탁감사
TRUADM	위탁경영
TRUEDU	위탁교육
TRUMIL	위탁급식
TRUINTT	위탁기관
CMCPNY	위탁기업
CMCPNY	위탁기업체
CNSGNR	위탁매매인
CNSGNBIL	위탁어음
TRURSINST	위탁연구기관
CNSGNOR	위탁자
CTTMLT	위탁판매
GIMCNSG	위탁판매물품
CSTRADE	위탁판매수출
MRNHN	위패봉안
INJRY	위해
DNGRL	위해물
HRMFL	위해성
RISK	위험
RSKMNGMT	위험관리
RSKMANG	위험관리기법
RSKGRP	위험군
DGDGR	위험도
DRLYS	위험도분석
DGST	위험물
DGRTCG	위험물취급자
DDNGFRCR	위험화물운반선
MENACE	위협
EXPT	위훈
WINDOW	윈도우
JACKET	윗옷
OILPRC	유가
VLUBL	유가물
SECRITS	유가증권
SRSL	유가증권매출
SSRCT	유가증권모집
STKT	유가증권시장
ACCDNT	유고
BONES	유골
MRTRS	유공
FDWR	유공압기기
MERITER	유공자
RELATE	유관
CRDNS	유관기관
AUTH	유권
ELCT	유권자
PAIDLV	유급휴가
ORGNIC	유기
ORGNICFARMNG	유기농업
ORGNICMTTR	유기물질
IMNTR	유기징역
ORGNICCHMSTRY	유기화학
ONCCP	유기화합물
_UNESCO	유네스코
UNSCACT	유네스코활동
UNIX	유닉스
UNIT	유닛
RELTE	유대
DERIVE	유도
TXSBSTTN	유독물
DYNMC	유동
LQDTY	유동성
SCDS	유동화자산
SZPY	유동화전문회사
SCRSCR	유동화증권
AMSMNT	유락
XCSSHP	유람선
ORGN	유래
FLUX	유량
FLWMTR	유량계
EUROPE	유럽
EURO	유로
PCHRG	유료
TOLROD	유료도로
TLRODINTDNC	유료도로관리청
FRJRC	유료직업소개사업
PAYTLT	유료화장실
OL	유류
LPNHR	유류분
DGLL	유류오염손해
GLASS	유리
GLSFIBR	유리장섬유
BHRC	유망
BYBGY	유모차
ENNC	유무
WRLS	유무선
RELIC	유물
INDUCT	유발
CLSSF	유별
RESRVE	유보
UBQTUS	유비쿼터스
SIMILR	유사
SRMRYG	유사군용장구
DIALCUM	유사누적
SIMILDEGER	유사도
SIMLGOD	유사물품
PSDPTRPD	유사석유제품
CFRBIZ	유사수신행위
SDGN	유사의장
HRTG	유산
CMPNS	유상
CTVL	유상계약
PICI	유상증자
CBLE	유선
ECSP	유선사업
SPFLD	유속
RUNWT	유수
RTDBSN	유수지
LOS	유실
LSTATC	유실물
INFNT	유아
EMULS	유액
RCRFSH	유어
TSTMNT	유언
_UN	유엔
_UNDP	유엔개발계획
_ILC	유엔국제법위원회
_UNCTAD	유엔무역개발회의
DGR	유역
ENO	유역환경청
POSTPNE	유예
USFUL	유용
PLSANC	유원
AMSPRK	유원지
ATENT	유의
PRFTB	유익
TMPT	유인
TMPPRF	유인이익
UNIQUE	유일
UQFTID	유일식별자
INFLOW	유입
USER	유저
RELICS	유적
OLFL	유전
GENE	유전자
GENTST	유전자검사
_GMO	유전자변형농산물
GMO	유전자변형생물체
GMMP	유전자변형수산물
_GMO	유전자변형식품
GMS	유전자변형종자
GENEBANK	유전자은행
GNRMBN	유전자재조합
GTHRY	유전자치료
GTCNRM	유전정보
DLCTRC	유전체
OWLL	유정
DYCTS	유제품
OKR	유조선
BRVFM	유족
BDBT	유족급여
BFLM	유족보상
BLSPN	유족연금
GLT	유죄
BQST	유증
MNTNC	유지
MNTMNG	유지관리
MNTNCE	유지보수
MNTMGT	유지보수관리
RHTNJ	유지청구권
OHD	유창
OHS	유창청소업
FLUID	유체
EFFLUX	유출
LAVL	유충
CNFMN	유치
CNFN	유치
LIEN	유치권
ACQCMS	유치수수료
KNDRGR	유치원
ENTC	유치자
SLPCUTD	유치증
INDCAR	유치지역
UTURN	유턴
DISTB	유통
DTMPL	유통단지
DCLLP	유통단지개발사업
DRCPNG	유통단지관리
DISTBNTWK	유통망
DISTBINDUST	유통산업
DBP	유통시설
DSTRBTRS	유통업
DOBC	유통업태
DBSNY	유통전문회사
NSTY	유통증권
DISTBSTDELCTRNDOC	유통표준전자문서
DISTBSTDCODE	유통표준코드
UTILT	유틸리티
SPRD	유포
SDYABR	유학
LDBTY	유한책임
IRRMY	유한회사
HRMFLNS	유해
HMGAS	유해가스
HRMFLNSPBLICTN	유해간행물
HMANML	유해동물
NXSS	유해사이트
HRMFLN	유해성
HMFLTS	유해식물
HFDBS	유해액체물질
HMWL	유해야생동물
HRMFLNSFCTR	유해요인
HLHSN	유해화학물질
FASHN	유행
EPDMCT	유행성
TY	유형
VALID	유효
EXPDATE	유효기일
ACTNG	유효성분
IDL	유휴
UNUSLND	유휴지
PLESR	유흥
AMSMT	유희
SI	육
OVRPS	육교
LFS	육군
SLVCLTR	육림
LAND	육상
LANDAGGRGT	육상골재
LRFC	육상교통
UNBRNG	육성
CHLDCR	육아
CLCLV	육아휴직
BRP	육양
LNDCRG	육운
BRED	육종
LAND	육지
LPNH	윤달
ACTPRST	윤락행위
MORALS	윤리
WHLXL	윤축
LBCL	윤활유
RT	율
FINANC	융자
LANMN	융자금
ACTBL	융통어음
NGTR	융통증권
FUSION	융합
CONCEALMENT	은닉
SCRCY	은밀
CNCEL	은폐
BANK	은행
BIC	은행국제코드
GNKG	은행나무
BPFRNCE	은행신용조회처
BNBS	은행업
KDNK	은행연합회
BPGURNT	은행지급보증
BHLDC	은행지주회사
GRDB	을종사태
LWD	음란
LRR	음력
DRKWT	음료수
DISC	음반
VOICE	음성
NGNO	음수
WFLY	음수대
FD	음식
RSTRT	음식점
MUSIC	음악
CHAL	음악당
SHDW	음영
DKPS	음용
DRNKG	음주
SOND	음향
EUP	읍
EMD	읍면동
COGMTL	응고성물질
EMGNCY	응급
EMRRSC	응급구조사
EMRRM	응급실
ERMCT	응급의료
EGYT	응급의료기관
ENTRN	응급의료종사자
EXPDNCY	응급조치
FRSAID	응급처치
EMGNCYPATNT	응급환자
ERNTRS	응급환자이송업
RSPNS	응답
RNTM	응답시간
RESPOND	응답자
RSPONS	응대
STRES	응력
APPLCN	응모
APPLCT	응모자
ACWCR	응분
APYEXM	응시
EXMNE	응시자
PRACTIC	응용
CVGNS	응집제
ADH	응착
ENTEND	응찰
OPINION	의견
WRTOPN	의견서
OPINIONPRESENTN	의견제출
OPNINQY	의견조회
OPNSTEM	의견진술
DECSN	의결
VHT	의결권
VTSK	의결권주
LTFR	의결서
PLICE	의경
MDCLG	의과대학
CSUT	의논
INTN	의도
CLHFD	의량
CRMNY	의례
REQEST	의뢰
RQSTDOC	의뢰서
CLIENT	의뢰인
CLIENT	의뢰자
MDLC	의료
MLLWNC	의료급여기관
MDLCNST	의료기관
MNSTW	의료기관세탁물
MDLP	의료기기
MCQP	의료기기취급자
HLTHINS	의료보험
MCP	의료비
MLFLT	의료시설
MDSFF	의료인
CLTHS	의류
DUTY	의무
PLICE	의무경찰
CPSEDU	의무교육
RPADUT	의무이행요구
RSPNER	의무자
AFFACT	의무화
DOUT	의문
INTRRGTV	의문사
MEAN	의미
DOCTR	의사
DSSYS	의사결정지원시스템
CSTM	의상
PRSEAT	의석
CNSCS	의식
CNSRSHP	의식
DOUBT	의심
BI	의안
MDCNE	의약
SSPMLC	의약분업
NRCLG	의약외품
MDCIN	의약품
LYCRG	의용
ASEMBY	의원
CHAIR	의자
CHRM	의장
DNG	의장권
HGD	의장대
CNSRSHP	의전
MDMST	의정
PRTCOL	의정서
LEGFICT	의제
AGENDA	의제
PRDFICT	의제기간
FCMTR	의제사항
FCSRN	의제상인
DPNDNCY	의존
DEPDEE	의존도
MDCINE	의학
MDPRP	의학용
INTEN	의향
ASMBLY	의회
TW	이
GAP	이격
DFNVW	이견
CRSITE	이고
SEDP	이공계
SENST	이공학
TRNSFER	이관
TRANS	이관년도
TRANSUSR	이관자
WITHIN	이내
IDLGY	이념
IDELGY	이념
ETHNT	이더넷
MVMN	이동
MBLTY	이동성
MOBLPHON	이동전화
MBTLNUM	이동전화번호
MLCMN	이동통신
MCNS	이동편의시설
MVVG	이동평균
MBRRM	이동화장실
ELRN	이러닝
ELRNBSNM	이러닝사업자
ELRNINDUST	이러닝산업
ELRNCNTNTS	이러닝콘텐츠
HIST	이력
THEORY	이론
TWOWHL	이륜
NM	이름
IRDM	이리듐
EMNL	이매뉴얼
EMAIL	이메일
OTHSD	이면
EMTCN	이모티콘
ALNSBT	이물질
IMAGE	이미지
IMGID	이미지ID
RMSTNIMGINFO	이미지목록
CORIDNT	이미지통합전략
IMAGEQS	이미지품질점수
EMGP	이민
IMPCY	이민정책
THTI	이번
EVENT	이벤트
HMV	이사
MOVGOD	이사물품
IMIGRNT	이사자
DRMY	이산가족
NO2	이산화질소
CO2	이산화탄소
SO2	이산화황
ABNRML	이상
ABOVE	이상
RLOCAT	이설
TRNSF	이송
COMPL	이수
CMPLET	이수자
CMPLET	이수제
ISSUE	이슈
ISMNGMT	이슈관리
DEW	이슬
TRNSPNT	이식
MPDFN	이식용수산물
STORY	이야기
TRANSF	이양
DFRS	이연자산
ION	이온
PMIEMS	이온교환막식기계제법
USE	이용
UTLINSTT	이용기관
BARBR	이용업
USER	이용자
NGHBHD	이웃
DLTY	이원화
CYFD	이월
CRRRT	이월과세
REASON	이유
PRFT	이윤
INTRT	이율
OBJC	이의
FOBJCT	이의신청
APLFMOJC	이의신청서
PROFIT	이익
PRFTS	이익금
PRFALT	이익배당
ENLRS	이익준비금
LPS	이임
INTR	이자
INRNT	이자소득
INTRT	이자율
ITCLM	이자채권
CGBST	이장
DISATR	이재민
RESPMT	이적
BEFORE	이전
TRANSR	이전
TRNPRCE	이전가격
TRFRGST	이전등기
MPS	이전비
MILG	이정
TBDST	이정표
XNGRAFT	이종이식
MOVING	이주
STTLER	이주민
DPLC	이중
HEVTAX	이중과세
DPLCTRDE	이중매매
DDREPRT	이중신고
DPLCSEIZR	이중압류
DPLX	이중화
LFLY	이직
BNRY	이진수
SECON	이차
DFINTRPRSV	이차보전금
TRFNTF	이첩
TRANSFR	이체
TRNSACNT	이체계좌
TRANSFRER	이체자
SCESN	이탈
SECDER	이탈자
BELOW	이하
MUMPS	이하선염
BMDSB	이항분포
UNDSTAND	이해
UDSTDPRCP	이해관계인
FLFL	이행
MGRT	이행
FFTK	이행과제
IMPBPR	이행불능
DVRC	이혼
PHCHEM	이화학
AFTER	이후
PRFTS	익금
NEXTYR	익년
ANNYMTY	익명
AYASTN	익명조합
EXPORT	익스포트
NXH	익월
NXTY	익일
PH	인
PSN	인
CNFM	인가
HUMAN	인간
SIGNET	인감
LBCST	인건비
HNDVR	인계
ARTIF	인공
MMWGI	인공수초섬
ATFCS	인공위성
HMRLR	인공임신중절수술
HWPG	인공증식
POPLTN	인구
PPLGRV	인구고령화
FLSPNR	인구집중유발시설
CENSUS	인구총조사
HNRT	인권
PHRT	인권옹호
NEARBY	인근
POPULAR	인기
PSNBY	인당
INDX	인덱스
DELY	인도
ODLR	인도명령
DELYCRMNL	인도범죄
DELVRER	인도자
DEVPONT	인도장
ETRRT	인도조약
DELYSCRITS	인도증권
DEVODER	인도지시서
CSDELVR	인도확인서명
HNF	인력
EXNCT	인멸
HNL	인명
SGL	인문
PRSN	인물
PRSNINFO	인물정보
INBND	인바운드
LFNNC	인보험
WRKMAN	인부
HR	인사
GRT	인사말
PPSS	인사정책지원시스템
GNSN	인삼
GSGKD	인삼류
GNSKDMK	인삼류제조
GNGC	인삼류제품
INCRSE	인상
RYALTY	인세
INCNTV	인센티브
PRNTNG	인쇄
PNTCTIND	인쇄문화산업
PRESS	인쇄물
PRNTOFC	인쇄소
PRNTR	인쇄인
UNDTAKE	인수
ZUNOS	인수공통전염병
UTRCR	인수모집
ACBK	인수은행
ACPTR	인수인
UDTK	인수일자
ACPTR	인수자
INSTN	인스턴스
RECOG	인식
PRSNTC	인신공격
SIGIL	인영
QOTAT	인용
NMPR	인원
LDIN	인입
FACTR	인자
ABLMAN	인재
MMDIST	인재
HN	인적
HNRC	인적자원
HNRCVL	인적자원개발
HRM	인적자원관리
MMDIST	인적재난
HNINFO	인적정보
NEARBY	인접
RCOGN	인정
CRTFCAT	인정서
ARTFCL	인조
HMRC	인종
CRTFC	인증
CRTFCT	인증서
AHRZT	인증서
ATNSR	인증자
CRTFCINDICT	인증표시
PAPSTMP	인지
CNN	인지도
STMPTAX	인지세
HSTAG	인질
MRGREL	인척
IC	인천
IC	인천광역시
GANGHWA	인천광역시강화군
GYEYANG	인천광역시계양구
ICNAMGU	인천광역시남구
NAMDONG	인천광역시남동구
ICDONGGU	인천광역시동구
BUPYEONG	인천광역시부평구
ICSEOGU	인천광역시서구
YEONSU	인천광역시연수구
ONGJIN	인천광역시옹진군
ICJUNGGU	인천광역시중구
HMNBD	인체
HMYM	인체조직
DRT	인출
ENCD	인코딩
INTNET	인터넷
ITNBNK	인터넷뱅킹
ITNNWP	인터넷신문
INPCT	인터넷신문사업자
ITNTEL	인터넷전화
ITNADR	인터넷주소
IAMA	인터넷주소관리기관
IAMP	인터넷주소관리대행자
ITNARER	인터넷주소사용자
INADRS	인터넷주소자원
INTRRPT	인터럽트
INTV	인터뷰
INTRFC	인터페이스
INTRPHN	인터폰
INTERN	인턴
INTRR	인테리어
ITRNT	인트라넷
INFRSTRCTR	인프라
INFZ	인플루엔자
RDCTN	인하
PRNPTG	인화
INHW	인화점
DE	일
ON	일
FAMLY	일가
EFL	일가창립
DILY	일간
DNEWSP	일간신문
SMMPRDY	일계
DLYW	일과
BNDE	일괄
BNDEBID	일괄입찰
BTCB	일괄작업
FSTCLSS	일급
WETHR	일기
WTHMP	일기도
SIGHBL	일람불신용장
SIGHBIL	일람출급어음
LSTTBL	일람표
SEQ	일련
SN	일련번호
FSTCLS	일류
SUNSET	일몰
JPNSNT	일문
GNRL	일반
GLHMN	일반건강진단
GPTBD	일반경쟁입찰
GNRLMRTGG	일반담보
GNRLAGENCY	일반대리점
GLBCRC	일반대형공사
GNRLROAD	일반도로
GNRLCTYGASBSNS	일반도시가스사업
GRBDDR	일반보세구역
GRLNSY	일반사면
GNTPN	일반사무수탁회사
GNLH	일반세탁물
ECGDECL	일반신고특송물품
GENRLC	일반신용장
GCSTC	일반압수물
GNS	일반용
GLCLD	일반용전기설비
GNRLMDCIN	일반의약품
PEPL	일반인
POIGS	일반직공무원
GNRLRLROAD	일반철도
GRYVH	일반철도차량
GNRLMESR	일반측량
GNRLSTATS	일반통계
GPTARF	일반특혜관세
GSP	일반특혜관세제도
GNRLSTR	일반판매소
GFTBIZ	일반화물터미널사업
ONSD	일방
DCNG	일변동
DALY	일별
JAPAN	일본
JIS	일본공업규격
PRTTN	일부
PRTINSR	일부보험
PRTAPL	일부상소
SOLRAD	일사
PADJ	일사부재리
NMO	일산화질소
CMO	일산화탄소
EDAY	일상
DAYCNT	일수
DT	일시
LMPS	일시불
TUCARG	일시양륙화물
POSE	일시정지
TMPLOAN	일시차입금
JPNSTY	일식
JPN	일어
SUN	일요일
DLY	일용
DYLRR	일용근로자
DELBR	일용직
DAIL	일일
DE	일자
FX	일정
SCHDUL	일정
FDSLM	일정거래분야
BLKINSP	일제검사
SUNSHN	일조
DIARY	일지
DDTY	일직
DWHR	일직자
FIRST	일차
MTCH	일치
DYRG	일평균
ASYY	일할
OTM	일회성
DSPPRD	일회용품
REDNG	읽기
OFCLP	임검
THRHLD	임계값
CRTSPD	임계속도
THRHLD	임계치
CMMS	임관
WAGE	임금
WLGR	임금대장
TENURE	임기
RENT	임대
RNTCHRG	임대가격
RNTCHRG	임대료
RTS	임대사업자
RNTAGNT	임대자
RTHOUS	임대주택
LS	임대차
FRSRD	임도
APDSMS	임면
APNT	임명
FRSTRE	임목
FRTR	임목육종
MISN	임무
FRN	임산공학
FSRCS	임산물
PWNM	임산부
CLINC	임상
CSCLG	임상심리
TMPR	임시
EXTOPOFF	임시개청
TMPHEXMN	임시건강진단
TMPMKT	임시시장
TMPCSD	임시영치
TMPWRK	임시작업
TMPLBR	임시직
PREGNAN	임신
FRTL	임야
FRSTR	임업
FRSTRY	임업인
GRLVF	임업총조사
FRTBCS	임업후계자
EMPLMN	임용
APTHYHD	임용권자
EXCTV	임원
RNDM	임의
PRAUCT	임의경매절차
RNDCPT	임의관할
RNDINCN	임의소각
RNDRSRV	임의준비금
VNTP	임의청산
FRLAND	임지
HIRE	임차
LEASRT	임차권
LESSEE	임차인
LESSEE	임차자
HIREVHCLE	임차차량
DEPS	임치
IMPRT	임포트
SEASHR	임해
JNCBT	입각
STDSGBRD	입간판
ENTDC	입거
PRSCT	입건
ENTEBORD	입경
WRHOUSNG	입고
WHR	입고자
STRPLC	입고처
ENTSCH	입교
ERCCR	입국
IAEPASG	입국검사장
ARENHAL	입국장
CUSTENR	입국지세관
RCPMNY	입금
RCPMNYER	입금인
DTT	입금일
RCPMNYER	입금자
JNPLTPT	입당
ENST	입대
IQNTY	입량
INPUT	입력
RGSDE	입력일
REGISTER	입력자
STNDTRI	입목
CUBE	입방체
LGSLT	입법
LTVW	입법권
ECNY	입사
ENCPN	입사일
WNPZ	입상
ENTRNC	입소
OBTIN	입수
DFT	입안
ADP	입양
ADCHLD	입양아동
FSHNG	입어
ENTFS	입어권
ERKS	입영
HSPTLZ	입원
INPTNT	입원환자
PARTCL	입자
ENTNC	입장
ADMFEE	입장료
ERLGR	입적
MVN	입주
MVINSTT	입주기관
MVCMY	입주기업체
PRF	입증
BFPF	입증책임
LCT	입지
ENTVHCL	입차
BID	입찰
BDDER	입찰자
SLD	입체
IPP	입출
WRHSDLVR	입출고
RCPPAY	입출금
IPTT	입출력
EDPCOFC	입출항처리세관직원
ENTSCH	입학
ETRNCF	입학금
ETRYPT	입항
IBNMANF	입항적하목록
IDPARVL	입항전수입신고
DPARVL	입항전신고
WTNESS	입회
OBSRVER	입회자
CANDIDACY	입후보
CNDT	입후보자
RESIDU	잉여
MAN	자
SELFINSR	자가보험
PRIVUSE	자가사용
PVTCAR	자가용
PVTUSE	자가용
BWPUSE	자가용보세창고
PED	자가용전기설비
PECF	자가전기통신설비
CCDOWR	자가통관
QUALF	자격
DISQU	자격상실
SUSPQUALI	자격정지
QLFSTK	자격주
CRQFC	자격증
SELFHELP	자구행위
DMTC	자국
WOMB	자궁
CPTAL	자금
FATF	자금세탁방지국제기구
MNYLADR	자금세탁자
MNDR	자금세탁행위
CPNCM	자금수입
CPTALBUDGET	자금예산
SPRFND	자금지원
CPTALEXPNDTR	자금지출
SLFSPL	자급
MGNTC	자기
SELF	자기
SFVLP	자기개발
RRTPY	자기계약
CR´CC	자기앞수표
CSRBL	자기앞어음
ECPTL	자기자본
TESSTK	자기주식
CHLDRN	자녀
ATMC	자동
ATMCPAY	자동납부
AEXPSYS	자동수출제도
ATCNG	자동이체
CAR	자동차
AUMACT	자동차관리법
CARMANAGEBSNS	자동차관리사업
CARLENDBSNS	자동차대여사업
CTB	자동차매매업
CARHOLDER	자동차보유자
ADSC	자동차보험
ADVR	자동차사용자
AMTX	자동차세
DVCHL	자동차운전학원
MTRWY	자동차전용도로
CARONLY	자동차전용선박
CRRPWRK	자동차정비업
SVBIZ	자동차폐차업
ATM	자동화
ACP	자동화선박
MAGNET	자력
DTA	자료
DTAMANAGESYS	자료관리시스템
RECSROOM	자료실
CPHR	자리수
ETHHD	자매결연자
CNSUT	자문
ADORGN	자문기관
LOK	자물쇠
JAVABAN	자바빈즈
SPNTN	자발
CHLPL	자병원
CAPL	자본
CPTLN	자본거래
CAPL	자본금
CLPL	자본잉여금
CLDS	자본재
CPTXPND	자본적지출
CPTSR	자본준비금
OES	자본지분표
CPTLZ	자본화
S'XPNS	자비유학
MMNY	자사
CRPCK	자사주
ASSETS	자산
ASRS	자산관리인
ANCPR	자산관리회사
ABS	자산담보부증권
ASSETSCSTDYCMPNY	자산보관회사
ASSETSHOLDER	자산보유자
ATMSK	자산운용협회
ASSETSCNSGN	자산위탁
ASSETSREVAL	자산재평가
ATPR	자산평가
SUCDE	자살
CHRTY	자선
PW	자승
CHLDRN	자식
SELF	자신
NATURE	자연
NRVW	자연경관
NRPRK	자연공원
NLGS	자연권
NRFRST	자연림
NNSVR	자연보전지역
NATHIS	자연사
NATUREECLGY	자연생태
NATUREECSYSTM	자연생태계
NATURERESRVEAREA	자연유보지역
NRP	자연자산
NTRLT	자연재난
NTRCMT	자연재해
NTVR	자연환경
NRVF	자연환경보전
RCRTFR	자연휴양림
MYBS	자영업
ULVRY	자외선
RESRCE	자원
FTSGC	자원비축시설
SLFDFN	자위
SLFDFRT	자위권
SLFDFNF	자위대
LBRTY	자유
FRTDR	자유무역지역
_FTA	자유무역협정
FMVN	자유발명
LBRTYUSEINFO	자유이용정보
DCIFTZ	자유지역반입신고
FREPORT	자유항
FRSTF	자유형
SLFCTRL	자율
SMBAREA	자율관리보세구역
SMYRATO	자율소요량
APFSAUT	자율심사대상업체
SLGLM	자율항목
XYLN	자일렌
MTRIL	자재
BCYCL	자전거
BCCRD	자전거도로
BCLQ	자전거이용시설
BCR	자전거횡단도
INDPND	자주
_FAQ	자주묻는질문
VOLUN	자진
VOLDECL	자진신고
VOLDECR	자진신고자
DSPST	자질
ONSLF	자체
SELFINSPCT	자체감사
SNSCNZ	자체감사기구
SNSTR	자체감사인
ISFPSL	자체처분
ISSM	자체평가
AUTN	자치
ATDRC	자치구
AMHTS	자치권
SFRND	자치단체
AMLL	자치법규
ASMN	자치행정
OSLHR	자타
OWNHOM	자택
KYBRD	자판
VEND	자판기
ATSM	자폐증
SLFSPT	자활
CDPNY	자회사
WRITR	작가
CMPS	작곡
COMPSR	작곡가
CMPSR	작곡자
FNCTNG	작동
NAMNG	작명
CMPSTN	작문
CROPS	작물
CSTRS	작물통계조사
CRPSM	작부체계
WRITNG	작성
WRTER	작성자
OPERT	작업
WKTE	작업대
WRKRUM	작업실
OPERTOR	작업자
WRKSHP	작업장
WRKORD	작업주문
WRKENVMSR	작업환경측정
ACTN	작용
ETMCS	작용기전
YESTD	작일
MTPR	작전
BRS	작전기지
PRDCT	작품
MGCNR	잔가스용기
BLCE	잔고
BLCE	잔고1
BLCE	잔고2
SURLUS	잔금
LAWN	잔디
BNT	잔량
RQCERTF	잔량증명서
REMN	잔류
HLDVR	잔류자
BLCE	잔액
BLNSHT	잔액장
REMNDR	잔여
RDMBD	잔여배아
RDPRTD	잔여재산분배
AFTFLM	잔염
SRVIVE	잔존
SVCLTS	잔존시설물
AFTGLW	잔진
LOCK	잠금
CNCL	잠복
SLKYRN	잠사
DVOPR	잠수작업
ENCRCH	잠식
SRICLT	잠업
LTNCY	잠재
PRVSNL	잠정
PRVMESR	잠정조치
MCDY	잡무
MSCLINC	잡수익
NSE	잡음
MSPRP	잡종재산
MSLND	잡종지
MGZN	잡지
WEEDS	잡초
IPLA	장
HED	장
LONG	장
CHPT	장
LDSTC	장거리
MNSTR	장관
OFCR	장교
INORG	장기
LNGTR	장기
LGCDS	장기금융업무
LCRR	장기복무제대군인
LRCDT	장기신용은행
LTDBT	장기채
TOY	장난감
LNRTR	장단기
MDRT	장단점
FUTU	장래
ENCRG	장려
SUBSID	장려금
ECGZ	장려상
FNRL	장례
OSTM	장루
GENRE	장르
SCENES	장면
WFMTH	장모
LNGT	장문
RCVSTLP	장물죄
ACNTBK	장부
AUDITG	장부조사
EQPMN	장비
EQTB	장비고장
PLACE	장소
LONGLF	장수
DECOR	장식
ORNMNT	장식품
TROBL	장애
TRBECNER	장애경제인
OBSTC	장애물
DSPSN	장애인
DSRPR	장애인기업
DPNRB	장애인표준사업장
DSPSN	장애자
OOBFACR	장외작업
LGDRD	장음
WFFTH	장인
MNTNG	장착
STORAGE	장치
DEVICE	장치
DURSTRG	장치기간
ODSRGOD	장치기간경과물품
STRGOD	장치물품
SHED	장치장
PLCSTRA	장치장소
TYPHD	장티푸스
EFLN	장학
SCHLSHIP	장학금
OBSTCL	장해
DLP	장해연금
RE	재
APPRV	재가
HTYGD	재가노인
HLFTY	재가시설
RESBSCRB	재가입
SDGAPRL	재감정회부
RESMPT	재개
REDEVP	재개발
ONGN	재개통
REBIDNG	재건축
ICGN	재검
RINSP	재검사
REPRUF	재검증
ADJDC	재결
OFREVEW	재결청
RECALC	재계산
INVNTRY	재고
RECINVR	재고기록
DCGN	재고장
REPBLANC	재공고
REISSU	재교부
RECP	재구성
RECOVR	재기
REDRFT	재기안
MSFRTN	재난
CMYN	재난관리
CYNLST	재난관리책임기관
MSFRTNCNTRMSRZONE	재난대응구역
FNDT	재단
FNDT	재단법인
LGN	재대출
RERGIST	재등록
CNVNL	재래
TDTMKT	재래시장
CVNLTP	재래식
CVWNS	재래식무기
DSCR	재량
MATRL	재료
RESALE	재매도
FNNR	재무
FNLTT	재무제표
PRPTY	재물
INVNV	재물조사
INTERST	재미
AGARTN	재반송
RECR	재발
ISGN	재발급
RESND	재발송
REISU	재발행
CTVT	재배
CTXR	재배시험
GROWER	재배자
CLTLND	재배지
REPOST	재배치
REASURE	재보증
REINSRN	재보험
ALWGN	재부여
CLGN	재분류
REDSTRB	재분배
BDN	재불량
REUS	재사용
PRPRTY	재산
PCSSYS	재산명시제도
PRPRTAX	재산세
PTAXSTAX	재산세과세표준
PINQSYS	재산조회제도
PRPRINVST	재산출자
REVIV	재생
REPRDC	재생산
REELCT	재선거
CCGN	재선택
REDSGN	재설계
RESETUP	재설정
ISLGN	재설치
PRISNR	재소자
RESEND	재송신
RERCIV	재수납
RERPR	재수리
RECLECT	재수집
RXPRT	재수출
DETIMPR	재수출면세
RETRST	재수탁
ECGN	재수행
RMATCH	재시
RETRY	재시도
RESTRT	재시작
REEXAMN	재시험
PLNTNG	재식
RESTTEMNT	재신고
REREQST	재신청
RETRIAL	재심
REJDGE	재심사
DSSTR	재앙
REEXTN	재연장
OVRSEA	재외
EMBLGBD	재외공관
OVSPSVNT	재외공무원
OVRSEKRN	재외국민
OVRSEKRNS	재외동포
REREQUST	재요청
FNRSC	재원
REMNDT	재위임
RECNSIGN	재위탁
CFNN	재유치
MVGN	재이동
REUSE	재이용
REEMPLY	재임용
REENTRY	재입국
REDPSIT	재입금
REBID	재입찰
READMS	재입학
REWRT	재작성
REWORK	재작업
ENRL	재적
REAPLC	재적용
RETRANSM	재전송
RECONECT	재접속
FNANC	재정
MOFE	재정경제부
REFIT	재정비
SFA	재정융자특별회계
REEXMN	재조사
READJST	재조정
GNRMBN	재조합
PAYAGN	재지급
PAYAGN	재지불
HFFC	재직
REENT	재진입
MTRQLT	재질
SCNDTM	재차
REHNDL	재처리
RERQEST	재청구
REBILD	재축
RECHRG	재충전
HMTRC	재택
TLCOMPUT	재택근무
SFA	재특회계
JDGMT	재판
JDGMTPARTCPNT	재판관계인
RHJSD	재판관할권
JRSDCT	재판권
RESALE	재판매
RLNNC	재판매가격유지행위
JDGMTDOC	재판문서
CRCD	재판서
RULLING	재판서편철
CORCD	재판서편철번호
RSCRT	재판청구권
REVAL	재평가
STDNT	재학생
REAPL	재항고
DSSTR	재해
MSAGDST	재해대책
DSSTRREWARDALOTM	재해보상부담금
DSSTRRECOVRYSBSIDY	재해복구보조금
DTRTDD	재해손실세액공제
CMYB	재해위로금
REPRMISN	재허가
REAPR	재현
CPRIGHT	재현생산권
WRSSS	재형저축
PPREMRG	재혼금지기간
CMDTY	재화
DWGHTN	재화중량톤수
RECNFRM	재확인
REHABT	재활
REACT	재활동
RUSE	재활용
ACTLDSP	쟁의행위
ISS	쟁점
LOW	저
LPRC	저가
REDUC	저감
RDCCR	저감반송파
LPLGN	저공해엔진
JRNL	저널
DINNR	저녁
MRTG	저당
MRTGA	저당권
MGDR	저당증권
LWFLBUS	저상버스
LTRRY	저서
SMLINCM	저소득
PWDSI	저소득자
LWBCT	저소득층
LWSD	저속
RSVWT	저수
WTTNK	저수조
POOL	저수지
LPSSR	저압
LOWTMP	저온
LTINSR	저온용기
LRRG	저온저장탱크
AUTHR	저자
CPYRHT	저작권
NHCHT	저작인접권
AUTHR	저작자
STRE	저장
SGTY	저장능력
REPO	저장문서함
SGQP	저장설비
STORGE	저장소
STGK	저장탱크
INCTV	저조
CNFLC	저촉
SVINGS	저축
THFINSTT	저축기관
LRRT	저출산
STKCOAL	저탄
DGRD	저하
RS	저항
RSSTRT	저항권
OBSTRC	저해
PROPER	적격
ENEMY	적군
PPRTM	적기
ACCML	적립
RSRVMNEY	적립금
DISCL	적발
LGAL	적법
PRPERT	적부
INTEG	적산법
RADBL	적색선하증권
SNOWD	적설
APTD	적성
PRPTM	적시
REDCRS	적십자
SUMRY	적요
APPLC	적용
APPLCDE	적용일
ADAPT	적응
SUITBL	적임
STUFNG	적입
DEFCT	적자
LDADNG	적재
EXLPERD	적재기간연장
CRGBRD	적재물
TLOBLG	적재의무기간
LDADNGLD	적재하중
PRPER	적절
PROPRT	적정
PRTPC	적정가격
PRTAIR	적정공기
RTDPHM	적조현상
STBLND	적지
PILEUP	적체
EXTRAC	적출
EXTRCTG	적출
EXRSTUF	적출입
ACCML	적치
CMST	적하목록
MRNUM	적하목록관리번호
MAFDISR	적하목록오류
QPMMANF	적하목록작성책임자
CORMANF	적하목록정정
MPUOBLG	적하목록제출의무자
MFCS	적하목록취합시스템
IRNC	적하보험
STBLT	적합
BFE	전
EM	전각
UNFLD	전개
DCRB	전결
RPLICE	전경
TTHGH	전고
MAJOR	전공
ARTR	전공의
CNGDY	전과
RAPSHT	전과기록
RAPSN	전과일련번호
LCA	전과정평가
RAPFVN	전과지문가치번호
BOARD	전광판
WNTY	전국
CNTRLRS	전국공통선별기준
ABSPLNP	전권대사
ELCTY	전기
FRMTRM	전기
ETWR	전기공사
ETCRR	전기공사기술자
FSTRM	전기말
ELDTY	전기사업
EBRLV	전기사업용전기설비
ELCTYBSNM	전기사업자
ELTL	전기설비
ENSLQ	전기수용설비
ELCRM	전기실
ERYT	전기용품
BTYCR	전기자동차
ELCTYVHCLE	전기차량
ELCNC	전기통신
ECYMR	전기통신기자재
ETMK	전기통신망
ETCMRV	전기통신사업
EMBS	전기통신사업자
ECTCCY	전기통신설비
ECMNL	전기통신역무
ECMP	전기통신회선설비
ELCTYSLEBSNS	전기판매사업
ELCTYSLEBSNM	전기판매사업자
JN	전남
PRVYY	전년
SHEAR	전단
DLIV	전달
DLVRR	전달자
ECSHG	전담
WPSY	전담관리기관
HALL	전당
SUBLS	전대차
CNDCTN	전도
ELECTR	전동
JN	전라남도
GANGJIN	전라남도강진군
GOHEUNG	전라남도고흥군
GOKSEONG	전라남도곡성군
GWANGYANG	전라남도광양시
GURYE	전라남도구례군
NAJU	전라남도나주시
DAMYANG	전라남도담양군
MOKPO	전라남도목포시
MUAN	전라남도무안군
BOSEONG	전라남도보성군
SUNCHEON	전라남도순천시
SINAN	전라남도신안군
YEOSU	전라남도여수시
YEONGGWANG	전라남도영광군
YEONGAM	전라남도영암군
WANDO	전라남도완도군
JANGSEONG	전라남도장성군
JANGHEUNG	전라남도장흥군
JINDO	전라남도진도군
HAMPYEONG	전라남도함평군
HAENAM	전라남도해남군
HWASUN	전라남도화순군
JNBK	전라북도
GOCHANG	전라북도고창군
GUNSAN	전라북도군산시
GIMJE	전라북도김제시
NAMWON	전라북도남원시
MUJU	전라북도무주군
BUAN	전라북도부안군
SUNCHANG	전라북도순창군
WANJU	전라북도완주군
IKSAN	전라북도익산시
IMSIL	전라북도임실군
JANGSU	전라북도장수군
JEONJU	전라북도전주시
JEONGEUP	전라북도정읍시
JINAN	전라북도진안군
STRTGY	전략
STTS	전략물자
STLLC	전략적제휴
STAGMAP	전략지도
WHINSPEC	전량검사
PWRER	전력
ECCRYS	전력계통
ERKL	전력기술
ERPLRS	전력기술용역
ERWL	전력기술인
ECTS	전력사용설비
PWLNCOMM	전력선통신
ELTPWMRK	전력시장
PWRDRV	전력유도
PRECEDNT	전례
ERCRT	전류
AMMTR	전류계
PRSPECT	전망
RESALE	전매
FRONT	전면
PCPBIZ	전무
SPCLTY	전문
EXPERT	전문가
SMINSTT	전문관리기관
SMINSTSYS	전문관리기관시스템
JNCLL	전문대학
SLLBY	전문도서관
SLZMDS	전문상가단지
SPCAPDR	전문수련의
STSFF	전문연구요원
SZDCN	전문의약품
SPTSC	전문조합
SCZDS	전문체육
WHOLE	전반
FRHFYR	전반기
FCRRR	전반송파
TRANSFER	전보
TLGRAM	전보
UPSE	전복
ALL	전부
JNBK	전북
CWO	전불
DTBT	전사
TQC	전사적종합품질관리
TQM	전사적품질경영
CMPT	전산
NCNC	전산원
CPTTCG	전산정보처리조직
CABL	전선
TDN	전설
LFSTS	전세
RLDB	전세권
LHPRSN	전세권자
TRNSMIS	전송
TRSMLNE	전송로
TRSMNWK	전송망
TRSMEQP	전송설비
TOTALTEST	전수검사
TACTIC	전술
TTHSPR	전술항공작전기지
DSPY	전시
PAVLN	전시관
EHBLL	전시장
EXBI	전시회
TELGRM	전신
TELPHPL	전신주
TGPTRNS	전신환
VLTGE	전압
VOLMTR	전압계
EXCFM	전업농업인
ECSHRM	전업어업인
DMBLZ	전역
INFEC	전염
ICTSD	전염병
DVR	전용
PRVUSE	전용
EXRGUSG	전용사용권
ESVS	전용서식
ESNS	전용실시권
ESRLY	전용철도
ECLLM	전용철도운영자
LLN	전용회선
SRCELCT	전원
SFCTLW	전원개발사업
PSINSTEQP	전원설비
LSMTH	전월
ELCPTT	전위
POSSESIONLEDGER	전유부
EXPSBULD	전유부분
TRAN	전이
BFRT	전일
FLTMSYS	전일제
PREDCESR	전임자
TRNSFRN	전입
MVINNM	전입자
ELCTRN	전자
BCNTSYS	전자개표
ELCCR	전자거래
ERNMSN	전자거래사업자
ETNCS	전자거래이용자
BVRFSYS	전자검표기
BBS	전자게시판
ERNCSL	전자관인
ELECTLIB	전자도서관
TABOFCON	전자도서목차
TAXBIZ	전자도서세무
ACC	전자도서회계
ECRNR	전자무역
ECTCC	전자문서
ENCXGT	전자문서교환방식
ECCST	전자문서시스템
IEPAPER	전자문서중계사업자
ETCCS	전자문자서명
EVPWC	전자민원창구
ERNC	전자상거래
ELTCMGD	전자상거래물품
ELTSGN	전자서명
ETSRCM	전자서명검증정보
ECSCR	전자서명생성정보
ELECBL	전자식선하증권
ETRRPT	전자신고
EDI	전자신고방식
ELECLC	전자신용장
ECNL	전자어음
ECBMCY	전자어음관리기관
EMAIL	전자우편
ECNSL	전자이미지관인
ERSNT	전자이미지서명
ERNSR	전자이체
ERPNMS	전자인사관리시스템
EGOV	전자정부
ERNRS	전자지갑
ECPBLC	전자출판물
ECRC	전자투표
ELTRNCVT	전자투표
ERMTW	전자파
EGVTL	전자파장해
ECCSLY	전자파적합
ECWRSR	전자파차폐성능측정
SCPR	전자파흡수율측정
ETRCSH	전자화폐
FRMRW	전작
BATTFLF	전장
WAR	전쟁
LWFR	전쟁법
PRUNG	전정
ELCTP	전주
CFMY	전직
SUBPLDGE	전질
TANK	전차
WSDC	전차금
SCARLIN	전차선
ELCRTRK	전차선로
ECLW	전철
ALL	전체
MVT	전출
MVMV	전출입
MVOTNM	전출자
TRDIT	전통
TRDCLT	전통문화
TDTBDHTML	전통사찰
TBTCA	전통사찰보존구역
CMBT	전투
RPLICE	전투경찰
RDOWAV	전파
RWTAX	전파세
RDOWVENV	전파환경
OVRWD	전폭
CHIT	전표
PRENUM	전호
TLPHON	전화
TELOFC	전화국
TELIDSAL	전화권유판매
TELIDSELER	전화권유판매자
PHONE	전화기
TELNO	전화번호
TELTAX	전화세
CNVRS	전환
SWITCH	전환기
STWK	전환복무
CBLBD	전환사채
CNVRSDE	전환일
CVTK	전환주식
PREV	전회
BRFTR	전후
JUL	절
REDCN	절감
INSI	절개
CTR	절개지
CTTN	절단
CUTTR	절단기
ABSLT	절대
THEFT	절도
HALF	절반
TRMMG	절사
CUTPRC	절삭가공
RVALT	절상
SAVING	절약
ITTRL	절연재
PSE	절전
TMPRN	절주
PROCSS	절차
POINT	점
CHCK	점검
INSCTR	점검자
VS	점성도
SCORE	점수
LUNCH	점심
PNTPLSRC	점오염원
OCPAT	점용
OCCPR	점용인
POSSESN	점유
PSESRT	점유권
OPWH	점유주파수대폭
BRLL	점자
JUMPER	점퍼
STOR	점포
ADNC	접견
BRLR	접경지역
BNSTR	접골사
ACCES	접근
RECEPTN	접대
RCPXPNS	접대비
ENTRTL	접대자
PREFIX	접두어
SUFFIX	접미사
SUFFIX	접미어
CONECT	접속
CONECTR	접속자
RCEPT	접수
RCPCNTR	접수대
RCEPTER	접수자
INFOFC	접수처
CSDHP	접안
CCNT	접점
INOCL	접종
GRND	접지
GRNDPART	접지부분
CONTACT	접촉
CNTCTR	접촉자
RGR	정
NETPRC	정가
STTN	정거장
RATING	정격
RTVOLT	정격전압
ATCSC	정관
MFRTC	정관변경
PRFSOR	정교수
FRL	정규
RGLLBR	정규직
DILIG	정근
JGGM	정글짐
ALLC	정급
FDRM	정기
PDICAL	정기간행물
PDCLBIZER	정기간행물사업자
CMMTKT	정기권
CMMBR	정기금채권
LINER	정기선
AGLMT	정년
FRNDTLK	정담
CNSR	정답
PPRTY	정당
PPEOFC	정당선거사무소
JST	정당성
DGREE	정도
FDQNT	정량
QYEVAL	정량지표
RFINE	정련
SORT	정렬
ORDNRY	정례
STOPG	정류
STTN	정류소
ARNG	정리
TRAY	정리함
RNDSS	정리해고
WIDUP	정리해산
THSIS	정립
VEIN	정맥
VNPRSS	정맥압
PLTAFS	정무
PLTSRV	정무직
PRECISE	정밀
PRCSDG	정밀도
PCSSFMXM	정밀안전검진
PCSSFDGN	정밀안전진단
ANCHR	정박
ANCHRG	정박지
PRCOFER	정범
INFO	정보
DTDD	정보격차
IFRMP	정보공개서
IFMVC	정보기기
INFOTCHNLGY	정보기술
ITAGM	정보기술협정
ITTK	정보망
INFOSCR	정보보호
INFOPRTCINDUST	정보보호산업
ITLTEAM	정보분석반
INNT	정보수사기관
IFETEM	정보외환계
IFMRS	정보자원
INFOPRCSNGSYS	정보처리시스템
IRMC	정보통신
IMNST	정보통신공사
ICNCSS	정보통신공사업
IFMCRB	정보통신공사업자
ICMD	정보통신기기
IMMMP	정보통신기반시설
IFCMMTCN	정보통신기술자
IFRNWK	정보통신망
MIC	정보통신부
INFCMNDSTRY	정보통신산업
IFCRV	정보통신서비스
IFMMVD	정보통신서비스제공자
IMMNS	정보통신설비
INFRM	정보화
ISP	정보화전략계획
FMTRS	정복교도관
OFCCPY	정본
GVRN	정부
_ODA	정부개발원조
GNNS	정부관리양곡
GVMAGNC	정부기관
GSEMERG	정부비축물품
GNLDZ	정부산하기관
GVRNPRCURE	정부조달
GNRNT	정부출연연구기관
GRNCM	정부출자기업체
IMPRMN	정비
RPRRM	정비실
RPARER	정비자
EXCCLC	정산
ECCCT	정산원가
STLDE	정산일
NRMLT	정상
NRRC	정상가격
NRML	정상운전
EMT	정서
QLEVAL	정성지표
PLTSTT	정세
INTGR	정수
CLWR	정수
WRFR	정수기
FLTPLT	정수장
FXTM	정시
FMY	정식
FCCLERN	정식통관절차
MIND	정신
PSYCHS	정신병
AFCS	정신보건시설
ATFLT	정신요양시설
MNDNT	정신의료기관
PSYCHPTH	정신질환자
SPE	정압
CNSPRS	정압실
FXAMT	정액
FSMTM	정액제
FDARTAB	정액환급율표
REST	정양
NOON	정오
GARDEN	정원
PSNCPA	정원
PSNRDC	정원감축
ORN	정유
CUBE	정육면체
DFN	정의
SPECF	정의서
PVL	정자
STATIC	정적
IFLCCW	정전
UPDT	정정
BFEUPD	정정전
AFTUPD	정정후
REFINE	정제
CTYG	정조의무
SETL	정주
STOP	정지
GTSTORT	정지궤도위성
STPCAR	정차
STTLE	정착
TKRUT	정착
RCONS	정찰
POLICY	정책
PCRM	정책고객서비스
PLCCMN	정책공동체
GPLCS	정책관리시스템
PLGL	정책목표
PCAA	정책분야
PLRM	정책영역
PCYFND	정책자금
PCYEVL	정책평가
PCYQTMNG	정책품질관리
CNGSTN	정체
IDNTTY	정체성
POLITC	정치
PLTFND	정치자금
MIC	정통부
AUTHNC	정품
CNFRMTY	정합
PRFCTN	정화
WRRTN	정화조
ACCRCY	정확도
RGLMMB	정회원
TRPINFEDU	정훈
MLCW	젖소
ECSC1	제1국민역
DFRTS	제2국민역
SCXPR	제2차납세의무자
TRDCNTR	제3국
THPTY	제3자
REMOV	제거
RAISE	제고
PW	제곱
PROVD	제공
OFFER	제공자
LDGG	제기
LGPRN	제기자
SGRMNF	제당
DMBLZ	제대
DRLR	제대군인
SYSTEM	제도
BRKG	제동
RLGCMN	제례
EXPLSN	제명
SJ	제목
ALSRT	제반
DIKE	제방
GVNF	제보
INFRMNT	제보자
UNFRM	제복
BKBND	제본
SNOWRM	제설
TAXDUE	제세공과금
TXS	제세금
DFBRL	제세동
APRINSUF	제세충당
FLWST	제소
ORTLT	제소명령
WTEXCL	제수
PRSENT	제시
PRSNTDDE	제시기일
PRSENTER	제시자
PROPSE	제안
PRPSL	제안서
RQPPS	제안요청서
PROPSR	제안자
RSTRCT	제약
CTRL	제어
CNTLR	제어기
PROPOS	제언
EXCL	제외
EXCLSTTEMNT	제외신고
MANP	제원
FIRS	제일
MNFCT	제작
MNFATC	제작물
MAKR	제작사
MAKR	제작자
PUNSH	제재
RMVRGS	제적
ESTBSH	제정
MDC	제제
MNFCTUR	제조
FOEXPNS	제조간접비
PRODCT	제조물
PDLBL	제조물책임
MAKR	제조사
MFCFT	제조상결함
MNFCTR	제조소
MFCRTR	제조업
MNFCTRR	제조업자
ODM	제조업자생산설계
MFBIZ	제조업체
MCTST	제조원가
MRS	제조위탁
MNFACR	제조자
MNFCTRY	제조장
PLMAFR	제조장소
JJ	제주
JFICDC	제주국제자유도시개발센터
SLJFIC	제주국제자유도시특별법
JJ	제주도
NAMJEJU	제주도남제주군
BUKJEJU	제주도북제주군
SEOGWIPO	제주도서귀포시
JEJUSI	제주도제주시
MCRTF	제증명
PAPMANF	제지
EXCLN	제척
EXCLPD	제척기간
RECMNDTN	제청
HRBCD	제초제
PRESENTN	제출
PRSENTR	제출자
TBLAT	제표
PRDUCT	제품
TAXPORD	제품과세
INBP	제품수불대장
LMTT	제한
RTTDR	제한구역
LDGH	제한물권
LTDVT	제한선거
LDT	제한세율
LMTLF	제한시계
LND	제한채권
COPRTN	제휴
TAK	조
SCLPTR	조각
CND	조건
CNDL	조건부
LDHC	조경
MINRT	조광권
MLGTSN	조광권자
ASTNT	조교
TRNER	조교사
ASSPSR	조교수
ELPD	조기
DSAST	조난
DIRGS	조난물품
WKCT	조난사고
PRCURE	조달
SPLGUD	조달물자
SAROK	조달청
HLPR	조력자
MCLNC	조례
SEAWEED	조류
TDLCRNT	조류
BIRDS	조류
COOK	조리사
AFFRST	조림
ASSMBL	조립
LGHT	조명
PRVSN	조문
CNDLNC	조문
COMP	조문구성
DSY	조밀
GNDPRNT	조부모
EXAMIN	조사
SIOFIC1	조사1관
SIOFIC2	조사2관
IVSVDIV	조사감시국
INVDIVS	조사국
WRINVSTG	조사서
INVTROM	조사실
EMRT	조사실시기관
IASECTN	조사심사과
SIASECT	조사심사과장
EXAMINSTAFF	조사요원
EXMNR	조사원
EXMNR	조사자
IIANALY	조사정보분석
IMTEAM	조사총괄계
INMSEC	조사총괄과장
PREMT	조산
MDWF	조산사
MTRHSP	조산원
PCCSPC	조생종
WTNNC	조서
EBBF	조석
SHPBILD	조선
SDSTR	조선산업
SLDSY	조선업자
MAKE	조성
MAKEPLAN	조성계획
TAX	조세
TAXDODG	조세범
TAXDODG	조세범죄
TAXTRT	조세조약
SPCCSE	조세특례
BTS	조수
TREATY	조약
TITCNTR	조약국
TITDRF	조약안
ADVISE	조언
FSHOPR	조업
JOIN	조인
MAPUT	조작
HNDL	조작
HNDLR	조작자
PRMOTE	조장
MSNR	조적
ADJST	조절
MDAT	조정
MDTR	조정자
RGLPND	조정지
PPRMDC	조제
CONTRL	조종
PILOT	조종사
ORGNZT	조직
OD	조직개발
ORGNZTMANAGE	조직관리
TSUDNR	조직기증자
ORGCHT	조직도
TSUBNK	조직은행
TSUTRPLNT	조직이식
SWTYARD	조차장
DISMONY	조출료
MANAGT	조치
MANER	조치자
LRLY	조퇴
MXTR	조합
ASSC	조합
MMBS	조합원
ARTCL	조항
STRNG	조향장치
SKLTHNG	조형물
HRMNY	조화
INQIRE	조회
RDCNT	조회수
IQRRSN	조회자
FUTTRC	족흔적
SBSIST	존립
CNTNNC	존속
EXST	존재
RTENT	존치
MNTNAB	존폐
GRDTN	졸업
GRDT	졸업생
GRDTB	졸업예정자
GRDT	졸업자
SPCS	종
CLSRC	종가
AVLDY	종가세
ED	종결
ENDD	종결구분
SYNPTC	종관
RELGN	종교
END	종국
ENDRGIST	종국등기
FLDG	종국판결
RADCL	종근
TMNS	종단
UNTTAX	종량세
END	종료
ENDDE	종료일
ENDER	종료자
KND	종류
KNDNM	종류명
CLSCS	종류채권
FTFCLT	종말처리시설
ITEM	종목
PLNSDL	종묘
RLGAFS	종무
ACMPLC	종범
ASORT	종별
ENGAGE	종사
ENFSN	종사자
DPNDCY	종속
TUMOR	종양
EMPLY	종업원
EYTTT	종업원급여총액
EPCKH	종업원지주제도
PAPER	종이
ALLDAY	종일
SEED	종자
SMNG	종자관리사
SNST	종자산업
SIDBIZ	종자업
SDBN	종자업자
TMNL	종점
AOSC	종중
BDSCK	종축
SBBIZ	종축업
GNRLZ	종합
CSBTRAN	종합간이보세운송업자
STHSSN	종합감사
MSTPL	종합계획
CNTD	종합과세
GRNPY	종합금융회사
CBAREA	종합보세구역
CBESTBL	종합보세사업장
CRTAX	종합부동산세
AEO	종합인증우수업체
KCSPI	종합주가지수
CMTX	종합토지세
LENNBRD	종횡
LFT	좌
SEAT	좌석
LFTBNK	좌안
SWING	좌우
LFTW	좌익
STRNDG	좌초
LEFT	좌측
CRDNT	좌표
CNTM	좌표계
CHGE	죄명
WEEK	주
FWWS	주40시간근로제
FWWS	주40시간제도
WKY	주5일
FWWS	주5일근무제
STKPC	주가
WIK	주간
0	주간선도로
RESIDE	주거
MNBS	주거래
BLDRSD	주거용건축물
SLBSD	주거용특정건축물
DWLSIT	주거지
DLTNS	주거지관할검사
VDCL	주거침입죄
MNRCR	주계약자
MNGT	주관
MNNST	주관기관
SBJCT	주관식
MNAER	주관자
SVRGNTY	주권
NLSTDR	주권비상장법인
CYCLE	주기
MSTVDV	주기관추진력
ESSR	주당순이익
MNRGST	주등기
DNPY	주량
MFRC	주력
ACHLQR	주류
ALQPST	주류규격
LDFACC	주류면세통관카드
ILLIQUR	주류수입면허
WKEND	주말
ACOFCER	주무
ORDER	주문
ORDRR	주문자
OEM	주문자상표부착
INHBTNT	주민
INGTCOPERTNFCLTY	주민공동시설
RSGST	주민등록
IHIDNUM	주민등록번호
RRC	주민등록증
SID	주민등록표ID
RMS	주민등록표원장조회시스템
IHIDNUM	주민번호
IHNTS	주민세
IBSTF	주민운동시설
INHBTNTFVN	주민지문가치번호
CFR	주변
HSWF	주부
INJCTN	주사
JROFC	주사
MNSG	주사용
CFNR	주상
PRDLOC	주생산지
CM	주석
AGENC	주선
LQTX	주세
ADRES	주소
ADBK	주소록
BUNJI	주소번지
ADRES	주소지
STOCK	주식
SCCNNP	주식공유
SCXH	주식교환
SCY	주식납입
APRSKH	주식매수청구권
SCDD	주식배당
SCKS	주식배정
STCD	주식병합
SCTPS	주식상호보유
SCRTR	주식소각
TRFSTK	주식양도
SCKP	주식옵션
SCFSK	주식인수
SCSCS	주식청약
SKMNY	주식회사
DGHT	주야
SUBJ	주어
MAIN	주요
MAINREMODEL	주요개조
LMCITEM	주요물품통관내역서
MWRCS	주요사업비
ARND	주위
LBRCT	주유
OLT	주유소
ATENT	주의
ADVSRY	주의보
ATPN	주의사항
OWNR	주인
INJEK	주입
INJCTR	주입기
RUNR	주자
ASSR	주장
WNSHP	주점
PRKSTOP	주정차
THEMA	주제
MNTRM	주제어
BRWY	주조연도
MSSN	주종
SHRHOLDR	주주
SKRT	주주명부
STKHLDCMPN	주주사
GMTSCK	주주총회
MDWK	주중
HPBTL	주지
MNNM	주지번
PARKNG	주차
PRKCMPRT	주차구획
PRKUCMPRT	주차단위구획
PRKPLCE	주차장
ECKBL	주차전용건축물
PRCRDBNK	주채권은행
CASTIR	주철
MBY	주체
GMTSCK	주총
AUSPC	주최
PRMTR	주최자
MEE	주출입구
PHTCHRG	주치의
HOUSE	주택
RDSTRT	주택가
HOUSECNSTRCAREA	주택건설지역
HPPR	주택공급면적
IHM	주택내
HOUSEBSNM	주택사업자
HFND	주택자금
MBS	주택저당증권
MTGRS	주택저당채권
MGCB	주택저당채권담보부채권
MGKRNY	주택저당채권유동화회사
FQNC	주파수
FRNCL	주파수분배
FQCNT	주파수지정
FQNCASGN	주파수할당
FQRMLC	주파수허용편차
USARMK	주한미군
USFKEB	주한미군시설사업
USFKEBEP	주한미군시설사업시행자
SOFA	주한미군지위협정
DRVNG	주행
COIN	주화
COMPET	준공
ACVLG	준농어촌
LWDR	준법정신
PRPARE	준비
RESVMNEY	준비금
PPRSTG	준비단계
BRIEFS	준비서면
QSICMCTRS	준상행위
DRDG	준설
QSILNCS	준소비대차
OBSRY	준수
APCRPND	준용
MGQIMGR	준이사물품
QUAIMGR	준이사자
QSPPL	준항고
ASSTB	준회원
SML	줄기세포
JOINT	줄눈
ZMLNS	줌렌즈
MIDDL	중
INADDUE	중가산금
MIDDLE	중간
IVND	중간배당
MIDDLEOMSRGIST	중간생략등기
MDLS	중간용기
INGODS	중간재
IRRJ	중간판결
MDIATN	중개
BRKCOMS	중개료
BGMS	중개수수료
BRKPG	중개업
BRKR	중개업자
BROKER	중개인
RLAY	중계
RLYSTT	중계국
RPEAT	중계기
INMTRAD	중계무역
RLYLNE	중계선
RLYLNE	중계회선
SCNDHAND	중고
UMGSH	중고물품
HEAVY	중과
HEVTAX	중과세
GRSNGL	중과실
JNGG	중구
CHINA	중국
CHNACC	중국강제인증제도
CHNLNG	중국어
TCR	중국횡단철도
HML	중금속
MLTRM	중기
MFCT	중기능
LAMRC	중남미
DSCNTC	중단
IMPRTN	중대
IMPRTNDSSTR	중대재해
MDSTRM	중도
PRTPAY	중도금
SLLLL	중도매인
ADDC	중독
POISNNG	중독
ADDICT	중독자
MDLSS	중등
SCYD	중등교육
SCH	중등학교
WT	중량
MIDL	중류
NTRLTY	중립
CHNSNT	중문
CAMRC	중미
DPLCT	중복
DNRC	중복보험
CENTRL	중부
MLSFC	중분류
SERINJ	중상
SWPSN	중상자
MLSY	중세사
SMLMDM	중소
SMLPZ	중소기업
MMPN	중소기업상담회사
MRRRS	중소기업자
MMRPGZ	중소기업자단체
MDLPT	중소기업자동화
MSLTM	중소기업정보화
MLPSC	중소기업창업투자조합
MSLRNN	중소기업창업투자회사
SMBA	중소기업청
SMLPZ	중소기업체
PCSME	중소기업특별위원회
KFSB	중소기업협동조합
RUSWTR	중수도
CENTER	중심
CENTR	중앙
N119RS	중앙119구조대
NLLN	중앙노동위원회
CRLKT	중앙도매시장
MNSP	중앙분리대
CTLN	중앙선
NEC	중앙선거관리위원회
CSC	중앙인사위원회
CRNRSY	중앙인사정책지원시스템
EXCTVE	중역
IMPRTNC	중요
IPCR	중요도
IMPRTC	중요성
JYG	중용
FSTLTN	중위
MDGTR	중장기
HQP	중장비
ARBTR	중재
ARBTOR	중재인
ATRV	중재판정부
ABTRG	중재합의
LILRW	중저준위방사성폐기물
EMPHS	중점
SRSILL	중증
SDBPN	중증장애인
STPGE	중지
GRSP	중징계
CTRNRV	중추신경
MIDCLD	중층운
MDELCWV	중파
MWVC	중파방송
PALSY	중풍
MSKUL	중학교
MSKLSD	중학생
MLCK	중형주
BIGAMY	중혼
SMJSC	즉결심판
POSJ	즉결심판절차
IMMY	즉납
IMDTL	즉시
IMINDCT	즉시고발
IRDREPRT	즉시반출신고
CSIRELS	즉시반출업체
AIRCMP	즉시반출업체지정신청
IDTPLN	즉시항고
BKMK	즐겨찾기
INCRS	증가
IRDS	증감
EVDNC	증거
WRTM	증거금
EVDENC	증거물
PRSVEVD	증거보전
SCRITS	증권
SRNTX	증권거래세
SYSTT	증권관계기관
SRCAL	증권관련집단소송
SCRCMPN	증권사
SCRBIZ	증권업
SCRCMPN	증권회사
VAPOR	증기
INCRE	증대
INCQTY	증량
SPRLIQ	증류주
PROOF	증명
CRTF	증명서
VPRZTN	증발
PRUF	증빙
SYMPTMS	증상
EDYC	증서
EXTNS	증설
SYMPTMS	증세
MTIPLC	증식
IRSD	증액
EVDNCE	증언
RTRTY	증언거부권
DONA	증여
DTX	증여세
IRTF	증원
WITNSS	증인
EMNWS	증인신문
INCC	증자
INCRZ	증진
ETBLD	증축
AMPLFC	증폭
AMPLFR	증폭기
VOCHR	증표
SYNDRM	증후증
PAPR	지
PCLND	지가
LATEN	지각
FRKLFT	지게차
EARTH	지구
DSTRC	지구
ERST	지구국
DSTPLAN	지구단위계획
PLCSTN	지구대
PYMNT	지급
DOCAPAY	지급도조건
PAYGRT	지급보증
AGPGURN	지급보증대리점
PAYMEAN	지급수단
PAYFEE	지급수수료
PYMNTAMT	지급액
PCSACT	지급원인행위
PAYBNK	지급은행
PAYR	지급인
PYMNTDE	지급일
PAYR	지급자
INTLGNC	지능
ITGNWK	지능망
ISTS	지능형교통체계
FNGTP	지단
CCH	지도
MAP	지도
GDNCC	지도경력
GIDBUK	지도서
LDERSH	지도층
BRIEF	지령
GIRO	지로
LMN	지뢰
BSTRM	지류
DM	지름
GRPH	지리
GGRPH	지리적
GRDC	지리적표시
GNGB	지리적표시단체표장
GRPHINFO	지리정보
GRPHINFODISTBNTWK	지리정보유통망
GRPHINFOSYSTM	지리정보체계
GRPY	지리학
LNDSRF	지면
NMFPC	지명
DCBDNG	지명경쟁입찰
SIWM	지명수배
MWACRIM	지명수배자
WATDLST	지명수배자명단
NTVCL	지명채권
LNDCGR	지목
FNGPRT	지문
JML	지물
GRUND	지반
LCLTY	지방
LLBSY	지방교부세
LCMNS	지방교육행정기관
LCLTYROADINTNDNC	지방도로관리청
LLSKT	지방도매시장
LCLTT	지방문화원
DNZWR	지방분권
LWTPY	지방상수도
LLX	지방세
LCPY	지방은행지주회사
LNTBNT	지방자치단체출연연구원
LNNC	지방재정
LLR	지방지역
LGFND	지방채
LCHBR	지방항만
LNTRT	지방행정기관
CNTL	지배
OSNTL	지배권
CSTKD	지배주주
LNM	지번
CHRDIS	지병
QOTA	지분
QUTART	지분권
QTTRNS	지분양도
PYMNT	지불
PYMNTMNY	지불금
PYER	지불자
RF	지붕
BRFFC	지사
GROUND	지상
TRRPHNM	지상
SPERFICS	지상권
BRHFC	지서
BRNCHLN	지선
GFE	지세
SBSTAT	지소
CNTNC	지속
DRBLTY	지속성
IDEX	지수
EXPNNT	지수
EXPSMTH	지수평활
DRCT	지시
ORDE	지시서
DRCTR	지시자
DBLTD	지시채권
KNWLDG	지식
CKO	지식관리담당임원
KNWLDGMANAGESYS	지식관리시스템
KLDGNR	지식기반산업
KNWLDGINDUST	지식산업
COP	지식실행공동체
RWLGN	지식정보자원
AREA	지역
RNVTX	지역개발세
RNFFD	지역교육청
ESMN	지역권
LOCLRS	지역세관별선별기준
LLPS	지역신문
AREASTRTGYINDUST	지역전략산업
RILO	지역정보연락사무소
ARASSC	지역조합
SSLDP	지역특화발전특구
SDCVL	지역특화발전특구계획
AREAINV	지역혁신
AREAINVSYSTM	지역혁신체계
DELAY	지연
OVDINTR	지연이자
RMVFEVR	지열
SPORT	지원
SPRMNY	지원금
SPNT	지원기관
SRNST	지원시설
SPRT	지원업체
SPRC	지원절차
SPPG	지원조치
SFLTSF	지원항공작전기지
POSIT	지위
ACQNTNC	지인
LOCGOV	지자체
TMBIMPRS	지장
LGSTR	지적
CDSRGST	지적공부
ILLT	지적재산권
LRVT	지적측량성과
SPOT	지점
BHF	지점
BRNMGER	지점장
APPN	지정
LIMITS	지정가
DSGINSP	지정검사
APNTT	지정교육기관
DDSHP	지정면세점
APCUTAT	지정문화재
DBAREA	지정보세구역
APBIZM	지정사업자
APPDC	지정서
ANTY	지정수량
APTLL	지정악취물질
APCMPY	지정업체
APNTDT	지정일
ASNR	지정자
DSAREA	지정장치장
APNSD	지정전염병
APFQN	지정주파수
APTR	지정통계
APPNWSTE	지정폐기물
ATHRR	지정항만
APNTADMCH	지정행정기관
PLLR	지주
HLDCP	지주회사
ERTHQK	지진
NTRFS	지질
BNFC	지청
DFRCMPST	지체상금
EXPNDTR	지출
EXPPSN	지출원
EPNS	지출원인행위
SLR	지층
MANUAL	지침
IX	지표
IDX	지표
UNDGRND	지하
UGRPLZ	지하광장
UNDPASS	지하도
UGRSTR	지하도상가
UGEEE	지하도출입시설
UGRWTR	지하수
UWDUCB	지하수개발이용시공업
UWPAR	지하수보전구역
UWEI	지하수영향조사
UWSDB	지하수정화업
SUBWAY	지하철
TPGRPH	지형
CMND	지휘
CMNDER	지휘관
CMTR	지휘소
CMMDR	지휘자
DRCCON	직결
DM	직경
DRTLNE	직계
LNLDCD	직계비속
LSNT	직계존속
JBGP	직군
OCTHT	직권
COAUTHR	직권정정
CLSF	직급
JTY	직능
FCGZ	직능단체
JLPRS	직능인
JBLN	직렬
OCPTY	직류
DCTR	직류
STDERC	직립
DTSL	직매
DTY	직무
DYRLSN	직무관련공무원
DYRS	직무관련자
DTYGRAD	직무등급
DTYCMMND	직무명령
INTH	직무발명
JOBANAY	직무분석
JOBDSGN	직무설계
DCSTY	직무유기죄
WVNF	직물
DCTSR	직배
DBCD	직불카드
DTRMB	직불카드회원
SRTLNE	직선
DBG	직속
DTNT	직속기관
OCCP	직업
VDTR	직업교육훈련
VDTTR	직업교육훈련교원
VCDTT	직업교육훈련기관
VDCRN	직업교육훈련생
OADBIZ	직업능력개발사업
OADT	직업능력개발훈련
OADTF	직업능력개발훈련시설
INTJOB	직업소개
OSINSTT	직업안정기관
OCCPSTABLELAW	직업안정법
PROEQUP	직업용품
OPNC	직업지도
VNCS	직업훈련과정
DROPER	직영
EMP	직원
OFCPS	직위
OLPBCR	직위공모
OFFCS	직인
WRC	직장
SFRN	직장훈련
BEFORE	직전
DIRECT	직접
DIRESUMG	직접밀수
DIRECTCT	직접비
DIRCTAX	직접세
PDTRNS	직접운송원칙
DIREPAY	직접지급
OCGNZ	직제
JSSFC	직종
RSPOFC	직책
DIRECT	직통
DCTCN	직할
DCMU	직할대
DTNMY	직할부대
CYCRTH	직할시
DSTDRT	진개
VACUUM	진공
FUNGUS	진균
PRMOT	진급
DGNSS	진단
RGAD	진단용방사선발생장치
DSPRS	진단자
RTPRGS	진도
SMINTS	진도
JDD	진도개
VIBRAT	진동
VBRWRK	진동작업
COSE	진로
CLNIC	진료
FE	진료비
CLNC	진료소
EPCN	진료원
PRGRS	진보
TRTH	진상
STATMNT	진술
STRTS	진술거부권
STTR	진술자
SUPESN	진압
EXHBI	진열
TRUFLS	진위
ENTRY	진입
ENTRYROAD	진입도로
ACCSSRD	진입로
STMLAT	진작
DEVLP	진전
RPRSENT	진정
RPRSNT	진정
GEUGOD	진정상품
PETITN	진정서
IFLD	진중
MDCXM	진찰
PRGS	진척
ADVNC	진출
PNUMCNSIS	진폐
PNUMCONS	진폐증
ERTDS	진학
PROGRS	진행
PGDRSGNL	진행지시신호
PGEVAL	진행평가
FRPOUT	진화
PROMTE	진흥
SETBUK	질
PLDG	질권
PLDGEE	질권자
MS	질량
QESTN	질문
DISS	질병
NTREST	질산에스테르
RGLART	질서
PLCLINE	질서유지선
RYNNC	질서유지인
N	질소
NOX	질소산화물
QUEST	질의
QLANG	질의어
QNA	질의응답
QSTNER	질의자
DISS	질환
HOUSE	집
SM	집계
GRUP	집단
GPPL	집단공급시설
DNLL	집단급식소
GRUPBL	집단선하증권
GRUPENERGY	집단에너지
GRYP	집단에너지시설
GRUPHOUSE	집단주택
CBARE	집단화지역
CLCDLVFC	집배송시설
MLMAN	집배원
GDROD	집산도로
WGR	집수정
MLKC	집유
MKCCPT	집유조합
ACCML	집적
BUMETH	집적법
IGRRT	집적회로
CNCTR	집중
CCTRR	집중도
WRIT	집필
AUTHR	집필자
SET	집합
AGBLDG	집합건물
GTHRTH	집합물
SPRPY	집합재산
EXCUT	집행
EXCUTCT	집행비용
EXCUTMNDT	집행위임
PRBATN	집행유예
EXCT	집행자
MTNG	집회
DSCPL	징계
DSCPLDSMSL	징계면직
DSLRC	징계처분
RQSTN	징발
CNSCRP	징병
CNSEXM	징병검사
TAXCLCT	징세
LEV	징수
COLTEAM	징수계
COLCTR	징수관
NCSTA	징수금액의최저한
COLDEFR	징수유예
TYPCOLE	징수형태
PNLSRVTD	징역
ENLST	징집
SGN	징후
COUPLE	짝
EVEN	짝수
SD	쪽
ATMB	차
DDCT	차감
GARAG	차고
GARAGE	차고지
VCMNSTR	차관
LONIMPRT	차관수입
DEB	차금
NXTTRM	차기
INTRCP	차단
CRCBRK	차단기
VIN	차대번호
RODWAY	차도
GRD	차등
VHCLE	차량
VHBSE	차량기지
VHCACL	차량용품
DDWGHT	차량중량
VHLMT	차량한계
RANK	차례
CARTRK	차로
BRWDNM	차명
BRWDNMACC	차명계좌
DEBTOR	차변
DEBNOTE	차변표
DSTNCT	차별
SEHIGH	차상위
TFCLNE	차선
DFNLOS	차손
ODR	차수
DFNNT	차액
SHADE	차양
BRW	차용
DMN	차원
OSTNDEBT	차월
DFFRNC	차이
DFRT	차익
ARTRD	차익거래
DIFBLCE	차인잔액
RNT	차임
BRRW	차입
BRRWLN	차입선
BRWOFC	차입처
VHCTY	차종
LESSEE	차주
ICG	차집
CBD	차체
SHLD	차폐
RFUND	차환
STRWRK	착공
CPFC	착공계
LANDG	착륙
COA	착부급
DES	착선인도가격
OUTSET	착수
DEPST	착수금
RCV	착신
AIM	착안
MISTK	착오
WEAR	착용
DRES	착의
CHCOFEE	착지불수수료
FRAGN	찬반
APPRVL	찬성
PARTCPT	참가
ADHRNC	참가인
ADHRNC	참가자
REFER	참고
REFE	참고인
VST	참관
WTNS	참관인
VSTPL	참관지
STFOFIC	참모
SECTN	참모처
WRSHIP	참배
ATNDNC	참석
ATDRN	참석자
PARTCPTN	참여
PRTCMPNY	참여기업
PRTCPNT	참여자
CNDRT	참작
PARTWAR	참전
MFMWCR	참전유공자
VOTRT	참정권
REFRN	참조
CC	참조자
REFPLC	참조처
RTRD	참조표준
WRHOUS	창고
WARCHRG	창고비용
WRHB	창고업
WRBND	창고증권
WICKET	창구
DEVPM	창달
FMTPLT	창당
FOPP	창당
FNDTN	창립
WNDW	창문
FNDTN	창사
ESTBSM	창설
FNTN	창업
BCTR	창업보육센터
FDY	창업일
FNDR	창업자
ORGIDEA	창의
ITTSPR	창의성
CRT	창작
CRETN	창출
SEARCH	찾기
MINING	채광
CDIT	채권
CREDIT	채권
BOND	채권
DFCNT	채권금융기관
LFLGS	채권법
BONDPSES	채권보유
CNG	채권양도
BONDFDZ	채권유동화
CRBK	채권은행
CRDTR	채권자
CTBY	채권추심업무
CTNF	채권침해
CRDACT	채권행위
CHNNL	채널
CHNNEL	채널
DET	채무
WRFL	채무면제
DTNBG	채무불이행
ACWMOBL	채무승인
DEBTR	채무자
STNCUT	채석
VGETBL	채소
EMPMN	채용
EMPYE	채용자
GRDNG	채점
SDGATHNG	채종
PICK	채취
CHOICE	채택
CHTT	채팅
BLDGTH	채혈
BSDCT	채혈부작용
VOLUMEINFO	책권정보
DTRSPB	책무
RSPNSBL	책임
RPBRV	책임감리
LTYNN	책임보험
RSPNBER	책임자
BKLET	책자
APRP	책정
CHLNG	챌린지
OFFIC	처
PROCESS	처리
TREDVS	처리과
PROPROD	처리기간
TREABL	처리능력
TREEQP	처리설비
TREDE	처리일
OPETR	처리자
PRCPLT	처리장
TREINFO	처리정보
PRCSNG	처리중
AFTPRC	처리후
EAVE	처마
PRSCRPTN	처방
PNISH	처벌
DSPS	처분
NOTFDISP	처분통지
TRET	처우
FRST	처음
SPERINTND	처장
WEATH	천기
TENT	천막
NTRE	천연
NGS	천연가스
NRNS	천연가스용기
NTRMN	천연기념물
NLBTN	천연물
NLSC	천연물과학
NRDT	천연물성분
NLWRDS	천연물신약
MCYS	천일식기계제법
CEILING	천장
NMTY	천재
NTRCMT	천재지변
NNMY	천적
SEASN	철
IRCVR	철갑
STEEL	철강
REMVL	철거
SRLFRM	철골
IRNPP	철관
RNFROD	철근
RLROAD	철도
RLDCNRBIZ	철도건설사업
RLRNTW	철도망
RLDACD	철도사고
RLRBIZ	철도사업
RLRINDS	철도산업
RLRFCL	철도시설
RLDFCMGR	철도시설관리자
RLDSGNL	철도신호
RTENP	철도운수종사자
RLDOPR	철도운영
RLDOPRTRB	철도운행장애
FRERAIL	철도인도조건
RLENP	철도종사자
RLRCAR	철도차량
KORAIL	철도청
WITHDR	철수
INTWR	철탑
ABL	철폐
WTHDRAW	철회
ADDIT	첨가
ADTV	첨가물
UPTODE	첨단
ADTECHIND	첨단기술기업
PKTM	첨두시
PEP	첨두포락선전력
ATCH	첨부
ATACHR	첨부자
ATCHMNFL	첨부파일
SCRINFO	첩보
FIRST	첫번째
FIRST	첫째
FIRCAR	첫차
ARSS	청각
PRTY	청결
RQEST	청구
CLM	청구권
BL	청구서
BILDE	청구일
BILLER	청구자
YGMN	청년
HEARAB	청력
INTGTY	청렴
AUDI	청문
GBD	청사
LQD	청산
LIQDATR	청산인
CLN	청소
YNGBGS	청소년
JNLG	청소년단체
JNPC	청소년보호
YOUTH	청소년보호위원회
JNFR	청소년복지
JLTLS	청소년시설
UBRTNAGR	청소년육성
TNGLDER	청소년지도자
JNVNC	청소년폭력
JTVTS	청소년활동
JLCY	청소년활동시설
SUBSCRPT	청약
SBRPDE	청약일
SUBSCBER	청약자
PETIT	청원
PSDP	청원경찰
DTVNFC	청장
PURTY	청정
CTHY	청정생산기술
PRTENRG	청정에너지
AUDE	청중
LISTN	청취
OFFICD	청코드
DECLR	체감
PHYSQ	체격
CNCLS	체결
CLPRN	체결자
SYSTM	체계
NPYM	체납
NPYMAMT	체납액
DTRG	체납요금
LDINQR	체납자
DQYDPST	체납처분
DPSFT	체납처분비
INRFB	체내
SDAP	체당금
FTNESS	체력
PHYCHT	체력장
STAY	체류
OVDWAGE	체불임금
ALSARDO	체비지
DEMURG	체선료
DYDEMUR	체선일
PCSURCH	체선할증료
SMTCEL	체세포
SCCE	체세포복제배아
CSGVF	체신관서
POCSVC	체신창구업무
CBTP	체약국자동차
BDHEAT	체온
CLLM	체온계
BDPOS	체위
PHSTRN	체육
GMNSM	체육관
ALCZ	체육단체
ALSFC	체육시설
PAFBIZ	체육시설업
PAFBIZER	체육시설업자
PTDRCTOR	체육지도자
CHAIN	체인
CHTB	체인사업
VL	체적
SYSM	체제
BDWGH	체중
PHYSG	체질
CECK	체크
CHKLST	체크리스트
CBX	체크박스
CHCKT	체크아웃
CHKIN	체크인
CKDY	체크일
ARRST	체포
AREWARN	체포영장
EXPRN	체험
EPG	체험단
BYP	체형
OVRDGOD	체화
SECND	초
SUPHSPD	초고속
IRPHG	초고속정보통신망
EXCESS	초과
OVTMWRK	초과근무
ESRC	초과보험
ERYY	초기
ELXMN	초기시험
INITL	초기화
MCRW	초단파
FNDBDC	초단파방송
ELEEDU	초등교육
ELESCH	초등학교
SCHBOY	초등학생
ABSTR	초록
ULFPTC	초미세먼지
ABSTRCT	초본
IVST	초빙
IVSTTCHER	초빙교원
SSFSFR	초상
GURPOST	초소
DRAFT	초안
ULTRSND	초음파
WBCUSTM	초일류세관
ULTST	초저온저장탱크
GRSLND	초지
GRLRR	초지전용
FSMDEM	초진
IVT	초청
CTLYST	촉매
PRMTN	촉진
ETTFF	촉탁
PTTMEP	촉탁자
TOT	총
GMGR	총감독
TOTCNT	총건수
POLCSP	총경
SM	총계
GLDGR	총계정원장
TDVALUE	총과세가격
SMRIZE	총괄
GRMS	총괄주관기관
TOTLDR	총괄표제부
TPPRICE	총구매가격
TOTAMT	총금액
SMLARMS	총기
GMOBL	총동원
TOTQY	총량
TOTAR	총면적
GRFR	총무
TOTSM	총산
GNSHOT	총상
TOTQY	총수량
TOTAMT	총액
WHLRS	총원
CLCTOP	총의
SCRTGENL	총장
GNLS	총칙
GRTG	총톤수
ECLL	총판
GENRVW	총평
FRMS	총포
TNPAKG	총포장개수
GLCL	총할
TOTAL	총합
TOTALWCAT	총허용어획량
GNRMTNG	총회
POTOGRF	촬영
MOCA	촬영기
STUDIO	촬영실
TOP	최고
TOPPC	최고가
RECENT	최근
MXM	최다
SHRTEST	최단
MXMM	최대
MAXIMTRF	최대수입관세
MXLDG	최대적재량
MVL	최대치
BSHR	최번시
PORNAT	최빈국
MO	최빈수
BEST	최상
BEST	최상위
MUMM	최소
MNLOPER	최소공정기준
MMACES	최소시장접근
MNVL	최소치
NEWEST	최신
MSTEXM	최심
MACSRVC	최일류세관
LNGST	최장
LWET	최저
MCSN	최저생계비
MMGSS	최저임금제
BMTB	최적
OPTRATE	최적관세율
BSTTY	최적방지시설
OPTMZ	최적화
LAST	최종
FRST	최초
FIMPRGOD	최초수입물품
BSEPRICE	최초예정가격
LOWEST	최하
LOWEST	최하위
MFANA	최혜국
MFNTREM	최혜국대우
LAST	최후
ADIT	추가
RSPG	추가경정예산
ADDECLR	추가신고
ADDER	추가자
RVSPBGT	추경
ESTMAT	추계
AUTUMN	추계
PRSUIT	추구
CHRSH	추모
BNSH	추방
CALCL	추산
ABSTRCN	추상화
PHMHNR	추서
TRND	추세
TKBAK	추심
CLCDR	추심명령
ESL	추심위임배서
DTCD	추심채무
SBSQACMP	추완
TRNSITN	추이
CNFRM	추인
TRACE	추적
PRSMP	추정
PRSMPPC	추정가격
PRSMPAMT	추정가액
PRSMPAMT	추정금액
CNTOLOS	추정전손
PRTN	추진
ADCHRE	추징
RECOMEND	추천
RECOMENDR	추천인
RECOMENDR	추천자
DRWT	추첨
EXTRC	추출
MSCNDT	추행
LTRN	추후
AXS	축
SOCCER	축구
FTBFLD	축구장
EMBNK	축대
STALL	축사
STKRS	축산
SCSNZ	축산단체
SFRMPRD	축산물
LSIND	축산업
LTKRSR	축산업자
LSKR	축산폐수
JTFSKW	축산폐수공공처리시설
DCLKTW	축산폐수배출시설
LTKWFT	축산폐수처리시설
RDTN	축소
ABBREV	축약
ACCUM	축적
CRRGR	축전
SRGBTRY	축전지
FSTVL	축제
BUILD	축조
SC	축척
DFB	출경
DLIVY	출고
FRRC	출고가
DLVRY	출고자
EXT	출구
DTRMC	출국
IADPASG	출국검사장
DHPDEPR	출국장
DEDUSHP	출국장면세매점
ATTEND	출근
ATNDN	출근자
DEFRAY	출금
DWD	출금일
RCPPMNT	출납
ACOFL	출납공무원
GUT	출동
GOT	출동대
APPRAN	출두
OUTPT	출력
PRINTNG	출력물
OUDSVC	출무
START	출발
STRTPNT	출발지
CHLDBRTH	출산
BIRTH	출생
ATEND	출석
RLSPRS	출소
CMT	출시
ORGIN	출신
DNT	출연
APLC	출원
APCTNTC	출원공개
APPLNM	출원인
CMG	출입
ENTRC	출입구
EDRCNT	출입국
ENCR	출입국검사장
IMRFR	출입국사범
CIQ	출입국지역
CGPN	출입자
CGPLC	출입장소
INVSTMNT	출자
PRTIVCP	출자인수권
BSRP	출장
BTRPS	출장비
AGNC	출장소
TRIPER	출장자
APRCRT	출정
STQEST	출제
LVVHCL	출차
ORIGIN	출처
EXCVT	출토
PBLCATE	출판
PLSCMPN	출판사
SHIPMNT	출하
TKOFF	출항
EMBRG	출항금지
OUTBMNF	출항적하목록
DEPRDEP	출항전신고
PRODEPR	출항절차
PERDEPR	출항허가
ERE	출현
HRGV	출혈열
IMPACT	충격
CHN	충남
SUPLE	충당
RSVMNEY	충당금
COLSN	충돌
IMPLS	충동
CB	충북
FLL	충실
RCRUIT	충원
LYLTY	충의
ELCTC	충전
CHRGR	충전기
ECHRGEQP	충전설비
CHRSTN	충전소
FLNTR	충전용기
CHRMN	충전인
TRUFL	충정
SUFFCN	충족
CHN	충청남도
GONGJU	충청남도공주시
GEUMSAN	충청남도금산군
NONSAN	충청남도논산시
DANGJIN	충청남도당진군
BORYEONG	충청남도보령시
BUYEO	충청남도부여군
SEOSAN	충청남도서산시
SEOCHEON	충청남도서천군
ASAN	충청남도아산시
YEONGI	충청남도연기군
YESAN	충청남도예산군
CHEONAN	충청남도천안시
CHEONGYANG	충청남도청양군
TAEAN	충청남도태안군
HONGSEONG	충청남도홍성군
CB	충청북도
GOESAN	충청북도괴산군
DANYANG	충청북도단양군
BOEUN	충청북도보은군
YEONGDONG	충청북도영동군
OKCHEON	충청북도옥천군
EUMSEONG	충청북도음성군
JECHEON	충청북도제천시
JINCHEON	충청북도진천군
CHEONGWON	충청북도청원군
CHEONGJU	충청북도청주시
CHUNGJU	충청북도충주시
VDE	충해
TRTMNT	취급
OFCE	취급소
TREFCT	취급시설
DSRBTR	취급점
TRPM	취급제한금지물질
ACQS	취득
ACQSPC	취득가격
ACQSTX	취득세
ACQPRD	취득시효
ACQDT	취득일
ACQSTR	취득자
HOBBY	취미
CANCL	취소
REVCRDT	취소가능신용장
IRVCRDT	취소불가능신용장
CNCDE	취소일
CNCLR	취소자
DBD	취수
FRGLTY	취약
EMPYMN	취업
INGR	취임
INSL	취임식
SBJSLCT	취재
CRG	취적
OBJET	취지
REGLT	취체
SLEEP	취침
WTHDRW	취하
ESHL	취학
CMBN	취합
GTTR	측구
MSV	측기
MESR	측량
MPNS	측량계획기관
MESRRCORD	측량기록
SYNG	측량기술자
SVYT	측량성과
SRVBS	측량업
SRYMN	측량업자
MRWKT	측량작업기관
SIDE	측면
SDTRCK	측선
SIDEPT	측점
MESURE	측정
MSRR	측정기
MESUREUNIT	측정단위
MSRSTN	측정소
ESTMTR	측정자
MESURESTD	측정표준
FLOOR	층
STRTUS	층운
DSGR	치과
DSDAD	치과의사전공의
MDLRT	치료
MCTTD	치료교육
CTVN	치료법
TREPTT	치료보호
CURER	치료자
SKIRT	치마
IMBCLTY	치매
KCSNRR	치산
FLDCTR	치수
TOOTH	치아
PBLPIC	치안
SSG	치안감
FIERC	치열
HL	치유
SUBST	치환
OSJCP	친고죄
PRIGHT	친권
INTMCY	친밀
INTIMDEGR	친밀도
ORCLD	친생자
FRENDSH	친선
KD	친절
RELTIV	친족
ACQNTN	친지
KIN	친화
FRDNSH	친화도
EVRFRND	친환경
ERRCRD	친환경농법
EVFDR	친환경농산물
ERFGCR	친환경농업
EYTCH	친환경농업기술
EDRTS	친환경상품
SV	칠
HRCHST	칠엽수
BEDD	침구
SBMRGUD	침몰품
INASN	침범
FLUD	침수
WASH	침식
BRM	침실
INVSN	침입
IDS	침입탐지시스템
LCHT	침출수
PENTRATE	침투
SNKG	침하
INFR	침해
INFRACDNT	침해사고
CHPST	칩셋
EXRCISE	칭찬
CARD	카드
CDMM	카드뮴
CARNET	카르네
CAMERA	카메라
CNT	카운트
CASINO	카지노
CATLYSIS	카타리시스
CTLG	카탈로그
CTGRY	카테고리
CAFE	카페
CRPL	카풀
COLLR	칼라
COLMN	칼럼
KMFLTR	칼만필터
CA	칼슘
CMADDS	캐드
CHARCR	캐릭터
CBNT	캐비닛
CACHE	캐쉬
CANT	캔트
CAMPUS	캠퍼스
CMPGN	캠페인
CAPTR	캡처
CNNCTR	커넥터
CMMNC	커뮤니케이션
CMMNTY	커뮤니티
FEE	커미션
COVER	커버
CURSOR	커서
CSTMZNG	커스터마이징
CFFS	커프스
CUPL	커플
CNVRTR	컨버터
CNVYR	컨베이어
CNSTNT	컨설턴트
CNSL	컨설팅
CNSRTM	컨소시엄
CNTANR	컨테이너
CNTRDTR	컨테이너검색기
CTDTPC	컨테이너검색기검사장
CNRM	컨테이너부두
CTLLF	컨테이너부두기능시설
CSCHARG	컨테이너서비스요금
CNTRBL	컨테이너선하증권
CNTFCT	컨테이너설비
CONTAX	컨테이너세
CSI	컨테이너안전협정
CNTYRD	컨테이너야드
CNTYARD	컨테이너야적장
BSCONLY	컨테이너전용보세창고
FCSHIP	컨테이너전용선
CTFRGS	컨테이너조작장
CNTCRN	컨테이너크레인
CNTMAL	컨테이너터미널
CNTANRFRGHT	컨테이너화물
CCICNTER	컨테이너화물검사센터
CNTNTS	컨텐츠
COLOR	컬러
COLUMN	컬럼
CMPLE	컴파일
COMPN	컴포넌트
CMPUTR	컴퓨터
CTCS	컴퓨터그래픽스
CPTVR	컴퓨터바이러스
CPPACT	컴퓨터프로그램보호법
CTPTL	컴퓨터프로그램저작물
CABLE	케이블
CODEC	코덱
CODE	코드
KRSSTT	코스닥
KOSDAQ	코스닥시장
KCSPI	코스피
COE	코아
COR	코어
COACHG	코칭
COCANE	코카인
COT	코팅
CNDMNM	콘도
CNCNT	콘센트
CNSLE	콘솔
CNCRT	콘크리트
CNTANR	콘테이너
CNTNTS	콘텐츠
CLLR	콜센터
CLLTX	콜택시
CMBCRD	콤비카드
KIDNEY	콩팥
CURIER	쿠리어
COOKIE	쿠키
COUPON	쿠폰
QUOTA	쿼터
QUIZ	퀴즈
QUEUE	큐
MG	크기
CRAK	크랙
CRANK	크랭크
CRANE	크레인
CRON	크론
CR	크롬
CLNT	클라이언트
CLASS	클래스
CLUSTR	클러스터
CLOCK	클럭
CLUB	클럽
CLAIM	클레임
CLINIC	클리닉
CLICK	클릭
HEIGHT	키
KYBRD	키보드
KWRD	키워드
_KM	킬로미터
_KB	킬로바이트
OTR	타
TRGT	타겟
FRNTN	타국
OTHINST	타기관
PROPR	타당
VLDTY	타당성
OTHRRGHT	타물권
OTHCMPNY	타사
OTHR	타소
TOWMET	타운미팅
ELLIP	타원
OVAL	타원체
SJ	타이틀
OTHER	타인
TMSTMP	타임스탬프
TMOUT	타임아웃
TY	타입
TYPING	타자
OYARD	타장치장
CNSGNM	탁송
CONSGN	탁송품
TABL	탁자
CMNR	탄광지역
FEXTARF	탄력관세
FBLF	탄력관세제도
FTXRATE	탄력세율
ELSTC	탄성
ELSYRN	탄성사
ELTBD	탄성체
AMMN	탄약
ENTRTY	탄원
CARB	탄화
HYDRCBN	탄화수소
WDRPRT	탈당
DRPT	탈락자
EFXS	탈세
DSRM	탈의실
SECSN	탈퇴
RECAPT	탈환
RESRCH	탐구
EXPLR	탐사
SRCH	탐색
DETCT	탐지
DTD	탐지견
DETCTR	탐지자
TWR	탑
BRDNG	탑승
LDADNG	탑재
TKWDO	태권도
TAG	태그
TGS	태극삼
ATITD	태도
ATIUD	태세
TSKFRC	태스크포스
FETUS	태아
SOLAR	태양광
SLCR	태양광자동차
SLRHEAT	태양열
SNSPOT	태양흑점
SABTAGE	태업
TYPHN	태풍
HDRY	택배
TAXI	택시
BLDLND	택지
TANKER	탱커
TNK	탱크
TANK	탱크
TNKSHIP	탱크선
TNKCNTN	탱크컨테이너
TUNNEL	터널
TRMINL	터미널
TRMNL	터미널
THCHARG	터미널화물처리비
TRBN	터빈
TSVMCH	터치스크린전자투표기
TSVTSYS	터치스크린전자투표및개표시스템
TENIS	테니스
TNNCRT	테니스장
BORDR	테두리
TERROR	테러
THEMA	테마
TEST	테스트
TABLE	테이블
TAPER	테이퍼
TAPE	테이프
TEXT	텍스트
TCMNWK	텔넷
TELMRK	텔레마케팅
TLMATIC	텔레매틱스
TLMATIC	텔레메틱스
_TV	텔레비전
CMLN	텔레비전공동시청안테나시설
TVBRDC	텔레비전방송
_TV	텔레비젼
TELEX	텔렉스
TMPLAT	템플릿
TGU	토구
DSCSN	토론
DEBATE	토론회
ENGRK	토목
PBCWRK	토목공사
ETND	토사
FLKWY	토속
SMT	토실
SOIL	토양
SPRV	토양개량
SLB	토양미생물
SLGRT	토양보전
GRL	토양오염
GLRFL	토양오염관리대상시설
STMNNT	토양오염물질
SWEEP	토양유실
SCXMN	토양정밀조사
SLRF	토양정화
SPRFBS	토양정화업
AGNKSRY	토양조사
SAT	토요일
DSCN	토의
LAD	토지
LNDBUK	토지대장
LNDWNR	토지소유자
LADDET	토지채무
EIVLT	토지초과세
EIVLT	토지초과이득세
NTTSL	토질
EIVLT	토초세
TQ	토크
TQWRNCH	토크렌치
TKN	토큰
TON	톤
TLN	톨루엔
TONG	통
STATS	통계
STCAGNT	통계대행기관
STFNT	통계작성기관
NSO	통계청
STATTBL	통계표
PUSH	통고
NTCDSP	통고처분
PASAGE	통과
THRMANF	통과목록
TRUGBL	통과선하증권
TRANDUTY	통과세
TRNCARG	통과화물
ENTR	통관
ENTRPAN	통관계획
ECTMRK	통관고유부호
CLERDIV	통관국
CPDIVS	통관기획과
WCCLER	통관보류
UNAACR	통관불허품
TRCLER	통관소요시간
CCAUDT	통관심사
CLERGUD	통관안내서
CCBUSNS	통관업
CCSTAT	통관역
CCPOFCE	통관우체국
CCAREA	통관장
CCPROCD	통관절차
CCLERN	통관지세관
SUCLSEC	통관지원과장
JPHCLER	통관취급법인
CUSTSEL	통관표지
ATNDF	통근
ALOG	통나무
PASSWAY	통로
DSPTH	통보
NTCDOC	통보서
ANNNCR	통보자
SUMUP	통산
CMERC	통상
NXVNS	통상실시권
ODYGS	통상임금
FBLAUCH	통선
PCPOINT	통선장
COMM	통신
COMMN	통신
CMCWR	통신망
ENSM	통신망장비관리시스템
CMNCR	통신보안
TELECOM	통신사
VDEC	통신사실확인자료
CMNBIZ	통신사업
CCB	통신사업자
CMN	통신서비스
CMFL	통신설비
CMNFTY	통신시설
CFRM	통신정보
MLL	통신판매
MSLBM	통신판매업자
MLSLD	통신판매중개
MSTZBD	통안채
INTRPR	통역
INTRPRTR	통역사
OPATIENT	통원환자
INTEGR	통일
EFNC	통일교육
UNIKOREA	통일부
BNKB	통장
CNRL	통제
CNTRDVY	통제배달
CNTLROM	통제실
NTICE	통지
NOTIE	통지서
ADVBANK	통지은행
GVRNM	통치
SRMWR	통치권
GNRPRCP	통칙
GENRULE	통칙자료
MRRBL	통폐합
ATNDSKL	통학
SPRVISE	통할
UNITY	통합
CPNOTIC	통합공고
ACPNOTC	통합공고별표
IRC	통합교육
INTGPAY	통합납부
IGPANOTC	통합납부서
IGPACMP	통합납부업체
IGRDN	통합방위
UNTDFST	통합방위사태
ITDNPR	통합방위작전
INERID	통합선거인명부확인시스템
UNYGNPW	통합출력
UCCJS	통합형사사법체계
PASNG	통행
SPRF	통행금지
PASMNY	통행료
CRNCY	통화
TALK	통화
MSTZBD	통화안정채권
CAF	통화할증료
LVHS	퇴거
LVSKUL	퇴교
LVFFC	퇴근
TURCOMP	퇴비화
WTICMPS	퇴비화작업
RETIRE	퇴사
MLTRDSG	퇴역
LHSTL	퇴원
RESIG	퇴임
AMN	퇴적
DEST	퇴적물
RETIRE	퇴직
DDTR	퇴직공제
RTRPAY	퇴직금
RFS	퇴직급여금
RRRSY	퇴직급여제도
RRSRT	퇴직연금사업자
RETIRER	퇴직자
LEAV	퇴출
CNQST	퇴치
WMHL	퇴학
DRPOT	퇴학생
DEGD	퇴행
PENTR	투과
SPECLT	투기
TRNSPRC	투명
TRNSPRCY	투명성
INVTRT	투신
MDCT	투약
MDCTN	투여
PRJCTN	투영
LNSTS	투융자
INPT	투입
INVT	투자
INVTRT	투자신탁
INVSTR	투자자
ICB	투자자문업
IVPMZNE	투자진흥지구
BDDPR	투찰
PRBDDR	투찰자
VOTE	투표
VTDSTR	투표구
VTRGHT	투표권
VTGCRD	투표권카드
POLPLC	투표소
BALBOX	투표함
TL	툴
TRFIC	트래픽
TRCTOR	트랙터
TRNSVR	트랜시버
TRNSC	트랜잭션
TRAP	트랩
TRLER	트레일러
TRUETY	트루타입
TR	트리
TRIGR	트리거
STRUCT	트리구조
TRINB	트리니트로벤젠
_TNT	트리니트로톨루엔
TRIMTA	트리메틸렌트리니트라민
SPCHS	특게세번
VHVOLT	특고압
SPCATC	특공대
SPCZON	특구
SNLN	특구토지이용계획
PRIVILG	특권
EMSVRC	특급우편물
EXPCARG	특급탁송화물
EXCACMP	특급탁송화물운송업체
SPCABL	특기
SPCMNT	특기
EXCPT	특례
EXPTAX	특례과세
EXCPTPRCURECNTRCT	특례조달계약
SPCCMND	특명
SPECL	특별
COUSM	특별관리법인
SCMNC	특별교통수단
SETARF	특별긴급관세
SPBLS	특별노동위원회
SLCT	특별담보
SLNSY	특별사면
SLX	특별소비세
SLCNT	특별지방행정기관
SPYBR	특별지원청소년
SLEVY	특별징수
SPCNWS	특보
SPCPRD	특산물
DCBIZ	특색사업
CHARTR	특성
CCRQ	특성주파수
EXPMAL	특송
EPECARG	특송물품전용통관장소
ERSCG	특송화물
SPCL	특수
SLNS	특수건강진단
SPCLD	특수건물
CSNNRT	특수경력직공무원
SLTS	특수고압가스
SLL	특수관계
RELTPRT	특수관계자
RPTRNS	특수관계자간거래
SPCEDU	특수교육
ECHCPD	특수교육기관
SCLRS	특수도서관
SPCSHP	특수선
OPGRQET	특수수사대
SNCT	특수압수물
SPCM	특수임무
SCRS	특수작전
SPCADRS	특수주소
SPCVCL	특수차
MVSGOD	특수차량
SPCSLSP	특수판매소
SSKUL	특수학교
SCS	특수학급
SCRSBC	특수형방사성물질
SPCCNTR	특약
CPCLPR	특용작물
SPECIAL	특유
SPRY	특유재산
PARTCLR	특이
SPPRDN	특작
SPCIFY	특정
SPCBDSTR	특정건축물
SCNTM	특정공무원범죄
SCSRK	특정공사
SPSTND	특정공정기준
SCCTSL	특정과제평가
SRMMR	특정대기유해물질
SFDS	특정도서
SCFTR	특정물질
SFCRS	특정범죄
SCQP	특정설비
OJPFR	특정소방대상물
SSWTY	특정수질유해물질
SCSFT	특정수혈부작용
SUTTSU	특정용도세율
SPPNT	특정조달계약
SCCMTC	특정화학물질
SPCEDIT	특집
SFE	특징
SPCSAL	특판
PATENT	특허
PATNTRT	특허권
LCNPROD	특허기간
PTNINVT	특허발명
LBAREA	특허보세구역
LCENFEE	특허수수료
SUCLCEN	특허의승계
PTNFROJC	특허이의신청
LCNSDOC	특허장
KIPO	특허청
PTNAPLC	특허출원
PRVLG	특혜
PRFLTRF	특혜관세
PTBCOUR	특혜대상국
PTBGOD	특혜대상물품
FRO	특혜원산지규정
SPCLIZ	특화
SLZS	특화사업
SPCLS	특화사업자
SPCUHU	특화세관
_TNT	티엔티
TICKET	티켓
TEAM	팀
TIMHDER	팀장
TIP	팁
DSPTC	파견
DTWK	파견근로자
DPRTR	파견사업주
WVHGT	파고
DESTRC	파괴
RLFT	파급효과
REVRSL	파기
PNRM	파노라마
WAVE	파동
PARAMTR	파라미터
PXYLN	파라자일렌
BLUE	파랑
PALLET	파렛트
DISMSL	파면
BNRPC	파산
TRUBKRP	파산관재인
ADCBNR	파산선고
ILRP	파산참가기관
TTNS	파상풍
DERIV	파생
DFNLS	파생금융거래
FNLTS	파생금융상품
DAMGE	파손
LETIDMT	파손화물보상장
DSNTGRTR	파쇄기
UNDSTN	파악
STRIKE	파업
PIPE	파이프
PPLINE	파이프라인
FNRCS	파인세라믹스
FILE	파일
FLPTH	파일경로
FLFLDR	파일폴더
WVLENG	파장
SEOUT	파출
VSTINSP	파출검사
BNFFC	파출소
PRTNR	파트너
PRTIME	파트타임
PRTITN	파티션
JUDMN	판결
RULINGDB	판결문DB2차
COPYR	판권
DCS	판단
INTPR	판독
RDR	판독기
PRCDNT	판례
COMNLAW	판례법
MARKET	판로
SLE	판매
STR	판매소
PSSYS	판매시점정보관리시스템
SALBIZ	판매업
DSTBR	판매업자
GODSAL	판매용물품
SELER	판매자
PAYSELR	판매자에대한지급
LMTSAL	판매한도
ASCE	판명
DSTNCTN	판별
JDGE	판사
JDGMNT	판정
PROMTN	판촉
FORMT	판형
EG	팔
PLDDAM	팔당댐
POPUP	팝업
POPUP	팝업창
AMB	패기
SHELFISH	패류
FAMILY	패밀리
FASHN	패션
PASS	패스
PASSWORD	패스워드
PTCHG	패칭
PCKAGE	패키지
PACKET	패킷
PCKTLOS	패킷손실
PTTRN	패턴
PACK	팩
FAX	팩스
FXNUM	팩스번호
PT	퍼센트
FCLITOR	퍼실리테이터
FUND	펀드
PULSE	펄스
PULP	펄프
FRBNK	펌뱅킹
FRMWR	펌웨어
PUMP	펌프
PUMPST	펌프장
PENLTY	페널티
PHNL	페놀
PGE	페이지
PAGE	페이지
PAGEINFO	페이지정보
PGNG	페이징
FLSF	페일세이프기능
PNSN	펜션
PENCONT	펜컨테이너
PNTHRT	펜트리트
PUN	편
ULTCNTR	편무계약
FRMTN	편성
ORGNZTN	편성
EDT	편수
CNVNC	편의
CVNTL	편의시설
CVNSTR	편의점
CNVNNC	편익
BDRATE	편익관세
INCRPR	편입
FRMTN	편제
EDIT	편집
EDTOR	편집인
DCLN	편차
CMPLAT	편찬
PYEONG	평
EVL	평가
EVLAMT	평가액
ACKEST	평가인정
AVRG	평균
AVGMTH	평균법
CATAMNT	평균세액증명서
AVRGWAGE	평균임금
ARGLD	평균전력
PLANE	평면
NORMAL	평상
ORDTM	평상시
LFTM	평생
CNTEDU	평생교육
CNDCN	평생교육단체
CNCTS	평생교육시설
AEA	평수
WKDAY	평일
FLTNSS	평탄
PTCUSTM	평택세관
BLNC	평형
PEACE	평화
SMTHG	평활화
ABDMA	폐광산
ABDNMA	폐광지역
ABSCH	폐교
PRCLSKL	폐교재산
DSUSE	폐기
REPRABOL	폐기결과보고서
WSTE	폐기물
WSRDFCL	폐기물감량화시설
WTDSLY	폐기물처리시설
DUSPSN	폐기자
CLG	폐문
BLCKD	폐색
BLCSC	폐색구간
CLS	폐쇄
CCTELV	폐쇄회로TV
WSTR	폐수
FTTDC	폐수배출시설
CLSBIZ	폐업
BIZQIT	폐업
CLSFLD	폐전
CLSTR	폐점
ABL	폐지
SCRCAR	폐차
ABNCHSP	폐천부지
ABAMGMT	폐합
EVIL	폐해
INCL	포괄
COMSECU	포괄담보
OPPOLCY	포괄예정보험
CLMP	포기
ABANDN	포기
FORUM	포럼
WPRSNR	포로
FRMAT	포맷
RWARD	포상
POINTR	포인터
FRMLC	포장
PACKNG	포장
PL	포장명세서
PACMETH	포장방법
PHM	포장유해물질
POSTN	포지션
CPTR	포착
FORK	포크
TAXEVS	포탈
PORTAL	포탈
PORTAL	포탈
PORTAL	포털
PORTAL	포털사이트
PORT	포트
PRTFOLIO	포트폴리오
PRTLET	포틀릿
PPLR	포플러
INCLS	포함
CAPT	포획
BT	폭
VIOLNC	폭력
EXPL	폭발
EXPLNSS	폭발성
HEVSNW	폭설
XPLSIV	폭약
BT	폭원
RKLSRN	폭주
BMAIL	폭탄메일
STORM	폭풍
PHONE	폰
PHONBNK	폰뱅킹
ONVY	폴
FOLDER	폴더
PYN	폴리곤
PLCLINE	폴리스라인
FOLIO	폴리오
PLYTHN	폴리우레탄
POLLNG	폴링
TABLE	표
TCKET	표
AL	표고
MARK	표기
FLTG	표류물
SURFC	표면
SFHHT	표면높이
EXPRS	표명
SAMPLE	표본
SPLSVY	표본조사
SAMPLNG	표본추출
INDICT	표시
IDCT	표시기
MARKR	표식
SLGN	표어
TARGT	표적
TITLELEDGER	표제부
STD	표준
SNSDR	표준규격
STMR	표준물질
SNSC	표준설계도서
STDLNG	표준어
SNWD	표준용어
SRDFS	표준정관
ENIP	표준통관예정보고서
STDIZ	표준화
SGNAL	표지
CEYE	표지병
SGNLBRD	표지판
AWRD	표창
EPRSS	표출
TOPSL	표토
EXPRSN	표현
QLY	품
RNK	품계
PRDNM	품명
PRDLST	품목
GIEITM	품목별수출입요령
PSR	품목별원산지기준
TRFCLSF	품목분류
PCTRF	품목분류사전심사
RPCTARF	품목분류사전회시요청
ITSSC	품목조합
ELGNC	품위
CNSUL	품의
CSLPSN	품의자
SPCIES	품종
VRPTRT	품종보호권
SPRNC	품종성능
QLITY	품질
QLTINSP	품질검사
QLTMNG	품질경영
QLTMNSYS	품질경영체제
QLMNGMT	품질관리
CRFQUAT	품질증명서
CNDCT	품행
WDPW	풍력
ANMMTR	풍력계
WDRS	풍배도
ABNDNC	풍부
BALLN	풍선
PBLMRL	풍속
WS	풍속
PMPLCR	풍속경찰
VFBC	풍속사범
BSFDTR	풍속영업
DSTD	풍수해
DBFRT	풍수해저감종합계획
WDDRFD	풍정
GRMMSL	풍진
WD	풍향
WTRG	풍화도
PRIVCY	프라이버시
FRNCHS	프랜차이즈
FRME	프레임
FRMWRK	프레임워크
PRO	프로
PRGRMNG	프로그래밍
PROGRM	프로그램
PGMATHR	프로그램저작자
PRGMRANAL	프로그램코드역분석
PROMTN	프로모션
PRCSR	프로세서
PROCS	프로세스
PROCDR	프로시져
PRJCT	프로젝트
PRTCL	프로토콜
PROFL	프로필
PROXY	프록시
PREMIUM	프리미엄
PRCNCT	프리캐스트콘크리트
PRINT	프린터
PLSTIC	플라스틱
AT	플래그
PLANT	플랜트
FRCONTR	플랫랙컨테이너
PLTFOM	플랫폼
PLFCNTR	플랫폼컨테이너
PRSNER	피고인
EDCT	피교육자
PYGEFCT	피그말리온효과
REFGE	피난
FDSIP	피더선
FDOPERT	피더선사
FDBCK	피드백
BKPD	피랍
IPS	피보험자
CLTH	피복
CRMT	피복재
SKIN	피부
SUCPTBL	피부민감성
SKNCLR	피부색
EBF	피선거권
_PC	피씨
OPRND	피연산자
TRUSTE	피위임자
INCSUP	피의
SUSPCT	피의자
CTCRLR	피임시술
BBD	피폭
DMGE	피해
SUFRER	피해자
DMGESTDNT	피해학생
LTHR	피혁
WRTNG	필기
FIELD	필드
FILM	필름
ESSNTL	필수
NEED	필요
NCSSTY	필요성
CERFIN	필증
LNDPCL	필지
LOT	필지
FLTER	필터
LWPT	하
SUMER	하계
LRCSS	하급
SUBORDD	하급자
ULADAIR	하기
LPT	하단
SUBCNTR	하도급
SCTC	하도급거래
HDDISK	하드디스크
_HW	하드웨어
HRDCD	하드코딩
FALL	하락
DWSTRM	하류
SHYY	하반기
LWPRT	하부
LPGZ	하부조직
NCMSOF	하사관
LVSP	하선
DECUNLD	하선신고
DFUNLAD	하선신고서
ULADARA	하선장소
CRTFLAD	하선증명서
SWGE	하수
SEWAGE	하수관거
SUBSPLY	하수급
SSYSN	하수급인
SSYSN	하수급자
SEWER	하수도
STPN	하수종말처리시설
BRDHOU	하숙집
LNL	하역
STEVDOR	하역업자
CGHNQP	하역장구
PLCDSCH	하역장소
CGG	하역장치
BLULOAD	하역적재업
RLULOAD	하역통로
PORDSCH	하역항
HOUSBL	하우스선하증권
HOUSNG	하우징
LWPRT	하위
PANTS	하의
HYBRID	하이브리드
HYBRIDCAR	하이브리드자동차
HHLFD	하이일드펀드
SHPMARK	하인
FLAW	하자
WRANTY	하자담보
WARANT	하자보증
PRDWARN	하자보증기간
CSTWARN	하자보증비용
LD	하중
GFF	하차
RIVER	하천
RGG	하천골재
SUBCNTCTOR	하청인
LWRLYR	하층
LWLVCLD	하층운
BTRV	하폭
LWLT	하한
LSLPC	하한가
GODN	하행
DWWD	하향
BNE	학
LNCCL	학계
SUBJCT	학과
SCHUL	학교
SCLMNGINST	학교경영기관
SCLEDUC	학교교육
SCLML	학교급식
SCLMLSTRD	학교급식공급업자
SCLLBR	학교도서관
ECLFD	학교법인
SCLEQIP	학교시설
SEQIPBIZ	학교시설사업
LNDSKUL	학교용지
ALSCHST	학교용지부담금
SCLVLC	학교폭력
CLAS	학급
SEMSTR	학기
GRADE	학년
ILTRT	학대
ACDMCR	학력
SCNCENM	학명
LRNNG	학문
STDNPRNT	학부모
SCHXPN	학비
SCHAFS	학사
STDNT	학생
SCHLSHP	학술
LRN	학습
LRNR	학습자
SCHOLSIP	학식
SCHULWRK	학업
ARSC	학예
INSTUT	학원
DGRI	학위
SCHXPN	학자금
SHPY	학자금대출증권
SLNN	학자금대출채권
DEAN	학장
SKNRGS	학적
PNT	학점
ELSM	학제
SKLRGL	학칙
LRSTY	학회
HANGANG	한강
LIMIT	한계
LIMITFRLND	한계농지
KOREA	한국
KTCOMI	한국무역위원회
KTNET	한국무역정보통신
KFTA	한국무역협회
CKRASOC	한국방사선동위원소협회의장
KS	한국산업규격
KTTASOC	한국섬유직물수출입조합
KLANG	한국어
BANKORA	한국은행
GBNKORA	한국은행총재
PGBKORA	한국은행총재의허가
HSK	한국형품목분류표
KECO	한국환경자원공사
KOREAN	한글
LMT	한도
CLD	한랭
CHCRT	한문
KRPNSL	한반도
TDTORNMDC	한방
TOMAD	한방전공의
HSDSS	한센병
HBMCN	한약
HRBS	한약사
MEDHRB	한약재
HRMN	한약제제
ORMDCDR	한의사
HBLD	한의약
HNCLG	한의약기술
ORMDCNC	한의원
CHCRT	한자
LMTT	한정
LMTABLER	한정능력자
LTRC	한정승인
QSINCMP	한정치산자
CGN	한지
AGAR	한천
CLDG	한해
ASGN	할당
TAFQUT	할당관세
TFQUSYS	할당관세제도
RQTRATE	할당관세추천
INSTLMT	할부
ALLTM	할부금
PIF	할부금융
PIFBIZ	할부금융업
DSCNT	할인
PRMIUM	할증
BX	함
CONT	함량
WSHIP	함선
SLWTR	함수
FNC	함수
FUNC	함수
CLTT	함양
CNTN	함유
CNAMT	함유량
WVSL	함정
UNDCVOPR	함정수사
SM	합
PSEXAM	합격
SM	합계
UNLMPTN	합명회사
LLSP	합법성감사
MERGE	합병
MRRSR	합병등기
MRDY	합병일
CMPLCT	합병증
ADUP	합산
JONTAXA	합산과세
SYNTH	합성
CPSTIMG	합성영상
LDGTGT	합숙
RDTGTR	합승
CNCRRNC	합의
CNCRRNCCMPTNC	합의관할
AGRTARF	합의세율
RPSSYS	합의제
RSAM	합의제행정기관
LDRRH	합자회사
CLLBR	합작
BYTGT	합장
HANG	항
CMPNAIT	항고
FLIGHT	항공
AFTN	항공고정통신망
ARTRTN	항공교통
AIRTKT	항공권
ARPLN	항공기
AMTRLG	항공기상
ARCRW	항공기승무원
ULD	항공기용탑재용기
BATREMT	항공기취급업
AHCPY	항공기취급업체
BUAVSVC	항공대리점업
FLIGHTSCRTYSTAFF	항공보안요원
FLIGHTINSRNC	항공보험
AIRMAN	항공사
AVACD	항공사고
PNR	항공사예약정보시스템
AIRPARL	항공소포우편물
ARPSNTFTCHN	항공우주과학기술
ARPINDS	항공우주산업
ARPBIZ	항공운송사업
ARPBIZM	항공운송사업자
AIP	항공정보간행물
AIRCARG	항공화물
AWB	항공화물운송장
PRT	항구
BCTRCDS	항균제
RUTE	항로
RXMN	항로조사
RPMTD	항로지정방식
HARBOR	항만
HARBORINTNDNC	항만관리청
HRBR	항만구역
HBCMPX	항만배후단지
HARBORFCLTY	항만시설
BHSRVC	항만용역업
HARBORTRNSPRT	항만운송
HARBORTRNSPRTRELATEBSNS	항만운송관련사업
HARBORTRNSPRTBSNS	항만운송사업
HRPTW	항만운영전산망
IEM	항목
DFNRT	항변권
ANTBTC	항생물질
ANTBIT	항생제
APPE	항소
CNSHMDT	항습
ORDTM	항시
ATICNMD	항암제
HMTHRML	항온
LUOPORT	항외하역
VOYG	항차
VYGNBR	항차번호
ASY	항측
VOYAGE	항해
VOYCHAR	항해용선계약
NVGT	항행
NVGTDSPTH	항행통보
SOLUT	해결
DISML	해고
NAVY	해군
NVLBS	해군기지
SHPWRCK	해난
SOLUTN	해답
CRRSPND	해당
MNCT	해도
HPHRB	해도제작업
OCRT	해류
SLVL	해면
EXPLN	해명
EV	해발
SLTN	해법
ANTMY	해부
MRTFF	해사
DSRGNZ	해산
SEA	해상
MSSEC1	해상감시1관
MSSEC	해상감시2관
SEATRF	해상교통
STGOW	해상교통관제방식
RSOLTN	해상도
MRNINSR	해상보험
SEAPTRL	해상순찰
MPTT	해상여객운송사업
OCNFRGH	해상운임
MRNRISK	해상위험
SEACARG	해상화물
MTRN	해상화물운송사업
INTRPRT	해석
INTRPRTN	해석법
EXPLNA	해설
DSSL	해소
SOLTN	해소
SEAW	해수
SLVL	해수면
HASHCD	해시코드
BEACH	해안
SHORLINE	해안선
OCEAN	해양
NMPA	해양경찰청
MSNC	해양과학조사
ORHCB	해양관측
MRNACD	해양사고
MRCTP	해양사고관련자
SPRCFCT	해양생산시설
OCMARBL	해양선하증권
MMAF	해양수산관청
MOMAF	해양수산부
RSCTH	해양자원
SEAPNM	해양지명
SAREA	해역
RMVFEVR	해열
OVSEA	해외
FNCCN	해외건설공사
FCTNT	해외건설업
FGNTTD	해외건설업자
FCTC	해외건설엔지니어링활동
_OECF	해외경제협력기금
OVSCONST	해외공사
OVSFTRTRD	해외선물거래
FCFM	해외선물시장
OVSEAWTRS	해외수역
OTPGOD	해외임가공물품
EPFRNC	해외자원개발
EPGSS	해외자원개발사업자
OVSMFT	해외재난
FGNTC	해외증권
FCSRT	해외직접투자
TPOPUCH	해외총취득가격
MRNTRNS	해운
SEATRNANC	해운대리점업
SHPCONF	해운동맹
SHPBIZ	해운업
SHPBRK	해운중개업
SAILOR	해원
TDLWAV	해일
RLSOFC	해임
SEAFLR	해저
SMDZ	해저광물개발구역
BTHS	해저광업
BHNGH	해저광업권
SMR	해저조광권
PIRATE	해적
RELIS	해제
CNLPSN	해제자
WDCGOD	해제절단등의작업
SEAWIDS	해조
SEAWIDS	해조류
TRMNAT	해지
RSCPSN	해지자
DISML	해직
DSMNTL	해체
DSPGN	해체
VESDISMT	해체용선박
HLSCT	해충
HCK	해킹
HAPPYCL	해피콜
NCLR	핵
NRWPS	핵무기
NRTLS	핵물질
FSMTR	핵분열성물질
CORE	핵심
KPI	핵심성과지표
NCLRFUEL	핵연료
NCLL	핵연료물질
NLFPCT	핵연료주기사업
NCRGG	핵연료집합체
NLRMT	핵원료물질
HDRLL	핸드드릴
MOBLPHON	핸드폰
HNDHL	핸드홀
ROW	행
GHVR	행동
CDCNDT	행동강령
PRSONPLSR	행락객
MTRIX	행렬
MSS	행방불명
HAPINS	행복
EVENT	행사
DSTN	행선지
GDL	행운
ACTION	행위
TRNSCTOR	행위자
LLTS	행위지법
MOGAHA	행자부
HMOSYS	행자부통합행정혁신시스템
ADMINIST	행정
ADMINISTZONE	행정구역
ADMINISTREGL	행정규제
ADMNSTMACH	행정기관
AEPROXY	행정대집행
ADSTRD	행정동
PSC	행정서비스헌장
ADLTACT	행정소송법
ADMACT	행정심판법
MOPAS	행정안전부
MOGAHA	행정자치부
ADMINISTESNT	행정전자서명
ADPRACT	행정절차법
ADMINISTINFO	행정정보
ADMINISTINFOSYS	행정정보시스템
ADMPSHM	행정제재
ADMNSTEXAM	행정조사
MTCTY	행정중심복합도시
ADMNSTGUDC	행정지도
EXAATHR	행정처분
ADMAGC	행정청
ADMCD	행정코드
STC	행정표준코드
ACTION	행태
CNST	행형
SPICES	향료
IMPRVNT	향상
ENTTN	향응
PSYDRG	향정신성의약품
NVPC	향토
RSRF	향토예비군
FUTR	향후
PRMISN	허가
PTHM	허가대상유해물질
RPMSN	허가서
PRMSFE	허가수수료
APLPRM	허가신청서
PRMCD	허가증
WAIST	허리
FLINTHGH	허벅지
HUB	허브
PERM	허용
ALSDGR	허용응력도
FLSHD	허위
FRPORT	허위신고
CFRPORT	허위신고죄
FSRW	허위표시
CNSTIT	헌법
CSTLT	헌법기관
CSTLN	헌법소원
CNSTITJDGMT	헌법재판
CCOURT	헌법재판소
CNSTT	헌장
BDNR	헌혈자
BDRNT	헌혈환부예치금
HUMP	험프
HDER	헤더
HDPHN	헤드폰
HEADG	헤딩
HERON	헤로인
HLCPTR	헬기
HELIC	헬리콥터
HLPRT	헬리포트
HDGRT	헷지비율
RVLTN	혁명
INV	혁신
CRRCCL	현계
CASH	현금
COD	현금결제
AUTOTM	현금지급기
PRAGE	현대
MDRNZ	현대화
SDLIGHT	현등
ACTHNG	현물
ISND	현물출자
PHNOMEN	현상
RLTY	현실
ATLOS	현실전손
PNDPRB	현안
CRNTAM	현액
STOPRT	현업
SPT	현장
INSPOT	현장검사
TESPOT	현장면세
SCCDUT	현장수납
SPTEMP	현장직원
CLERSPT	현장통관
NOW	현재
ACPLC	현지
LSDY	현지법인
NMB	현충원
PHYINSP	현품확인
CUR	현행
FNTFN	현행범
STTUS	현황
BLDVSS	혈관
BDSG	혈당
BRSSR	혈압
BLOOD	혈액
BMNS	혈액관리업무
BLOODEXPSR	혈액노출
BIID	혈액매개감염병
NBBRD	혈액원
BDDC	혈액제제
BDP	혈액형
BLDRLT	혈연
ONLBD	혈족
SERUM	혈청
SRMB	혈청은행
ABHRR	혐오
ABMNTN	혐오시설
SUSPIC	혐의
NSM	협대역시스템
NRBDTN	협대역직접인쇄전신장치
CPER	협동
CRSHDL	협동연구개발
CPRT	협동화
CORPR	협력
CPRBIZ	협력사업
CCPY	협력업체
NTAT	협상
AGREM	협약
CNVN	협약
AGCNCE	협약당사국
AGRMNT	협약서
AGRBD	협약증서
CPRTN	협업
DSCSS	협의
CFRNC	협의회
TRTY	협정
CVTLTRF	협정관세
AGIVLUE	협정보험가액
HELP	협조
CRRF	협조부처
SPPRTR	협조자
ASOC	협회
FLRS	형광
TRMIMPSN	형기
MLDPH	형깊이
PETY	형벌
CRMLACT	형법
CMLC	형사
CRNND	형사보상
ARCH	형사사건기록
PSV	형사사건기록보존
CMPRACT	형사소송법
CMLLY	형사책임
FRM	형상
FRMATN	형성
FOM	형식
FRMM	형식시험
CHARC	형질
STLE	형태
BNEF	혜택
ISSNO	호
HO	호
CP	호가
DNFNSC	호국
HNAM	호남
HRMN DRG	호르몬제
SRCLS	호봉
MLLC	호선
LKMH	호소
ESCORT	호송
LKE	호수
HOSE	호스
HST	호스팅
RVTMNT	호안
FLTR	호적
HUSEDR	호주
SCTD	호주승계
CALL	호출
CLSGN	호출부호
NM	호칭
HOTEL	호텔
RSPRTN	호흡
RSPORG	호흡기
RPTGM	호흡기보호프로그램
CNFSN	혼동
WEDNG	혼례
JAMG	혼신
MRRG	혼인
CNF	혼잡
CGSFS	혼잡통행료
CNSLDAT	혼재
LTCLBBC	혼재화물
CCMANF	혼재화물적하목록
MIXTR	혼합
MDCDUT	혼합세
MXBS	혼혈인
ODD	홀수
HRK	홈네트워크
HMPG	홈페이지
PR	홍보
PRPRP	홍보성
REDGNS	홍삼
FLOOD	홍수
MSLS	홍역
FIREAM	화기
SCRIN	화면
FRGHT	화물
CRGMANG	화물관리
CMNUMBR	화물관리번호
CRGMANR	화물관리인
TRKMNM	화물단위체
ARMTCE	화물도착통지서
CRGDSRP	화물명세
CTLRT	화물상환증
CHP	화물선
CRGSELC	화물선별
FRWARDR	화물운송주선업자
LDRESRC	화물의적재제한
CAREPRT	화물이상보고
DLVYORD	화물인도지시서
TRUCK	화물자동차
TTABIZ	화물자동차운송가맹사업
TTABIZER	화물자동차운송가맹사업자
TTMMBSTR	화물자동차운송가맹점
TTBIZ	화물자동차운송사업
TTGOBIZ	화물자동차운송주선사업
TTRBIZ	화물자동차운수사업
LCBOARD	화물적재목록
FHTRPC	화물적재장소
CCTINFO	화물진행정보
COFRSTA	화물집하소
FRGHTOFCE	화물취급소
FGTRML	화물터미널
FTLBS	화물터미널사업
ARRW	화살
BURN	화상
_CBR	화생방
PIXEL	화소
GNPDER	화약
GNPDER	화약류
FLAME	화염
MVKL	화염병
TUES	화요일
HRMY	화음
NSPC	화의
FILE	화일
CRM	화장
TOILET	화장실
CRMTRM	화장장
CSMTCS	화장품
FIRE	화재
OWR	화주
FTCR	화차
CRRNCY	화폐
CHMSTRY	화학
CMLS	화학무기
CHMCLS	화학물질
CHOXDM	화학적산소요구량
CMLBR	화학적합성품
DOCTLC	화환신용장
FLPLNT	화훼
EXPANS	확대
RPBLTY	확률
ESTBLSH	확립
ENSURE	확보
DFF	확산
DCDFPR	확약서
CNFIRM	확인
CNFRMN	확인서
CNFCOMS	확인수수료
CNFRLC	확인신용장
CONFBNK	확인은행
CNFRMR	확인자
ESTN	확장
EVENTN	확장명
ENHAUDT	확장심사
EXTSN	확장자
EVENTN	확장자명
DCSN	확정
FINPRCE	확정가격
DNNTP	확정급여형퇴직연금
DTRNN	확정기여형퇴직연금
FRMOFER	확정청약
EXPN	확충
COMONY	환가
EXCCOMS	환가료
EXCIMOE	환가처분
ENVRN	환경
ENLMN	환경경영
EVNMGS	환경경영체제
EGSTR	환경경영체제인증
EVLL	환경기술
ERBSQ	환경기초시설
ENRC	환경방출
EVSR	환경보전
ENVRNPRTCCMIT	환경보호위원회
ENVRNPRTCAREA	환경보호지역
ME	환경부
ENNBL	환경분쟁
ELSR	환경산업
ENVRNEQP	환경설비
ENVRNL	환경성
EVRQP	환경시설
EVNP	환경오염
EPSR	환경오염신고포상금
EPSRS	환경오염신고포상금제도
EVLLM	환경용량
ECFRND	환경친화적
ECFRNDCAR	환경친화적자동차
ERNMG	환경피해
EVNFM	환경훼손
RETUN	환급
DIOEP	환급가산금
DRBDIRT	환급관리자
REFUND	환급금
PBDAMUT	환급금지급은행
DRBDGCE	환급기관
SFCHDBK	환급담당자
RAWMDBK	환급대상원재료
DWBKSYS	환급시스템
DWBKRQST	환급신청
DWBKAPC	환급신청인
DAESEC	환급심사과
DRWAUDR	환급심사자
DRBMANG	환급운영자
DBKBANK	환급은행
PADDWBK	환급전심사
RGCLDRW	환급청구권
POAUDBK	환급후심사
VENTL	환기
FAN	환기구
VTLEQIP	환기설비
FDBCK	환류
REPRCHS	환매
ESRNL	환배서
RETUN	환부
REFND	환불
CNVRSN	환산
FRWLL	환송
REDEMP	환수
TRNSIT	환승
TRFFCT	환승시설
TRTTPRK	환승주차장
CYCLIC	환식
BLXG	환어음
WLCOM	환영
RSTORE	환원
EXNGK	환위험
ENGKG	환위험관리
EHGT	환율
ECHNG	환입
PATNT	환자
TRANSHIP	환적
TRANGOD	환적물품
TRNSHBL	환적선하증권
ESSTRSM	환적시조기보안검색
TRNSHCG	환적화물
EXCNG	환전
BMEXCH	환전업
RPLOT	환지
EXCHRS	환치
EXRFN	환풍기
ACT	활동
ACTVTYBSDCST	활동기준원가
ERY	활력
ACTVTY	활성
PRCUSE	활용
SLDTARF	활척관세
SULFUR	황
YLWSND	황사
WTLND	황폐지
ACCNUT	회계
APOFCAL	회계공무원
ACPOF	회계관계공무원
ACCNUTCMDEMP	회계관계직원
FSSE	회계구분
FSYR	회계년도
ACNTBK	회계장부
SESN	회기
CNVRST	회담
TLKNM	회담명
TLKFLD	회담분야
CVRSM	회담상황실
CVFDRN	회담종사자
CRMNTT	회담주관기관
RSPNS	회답
TRNRD	회람
CRCT	회로
AFASTN	회무
NSLET	회보
RECVRY	회복
RSRR	회복등기
FRWRD	회부
DUES	회비
CMPNY	회사
CNYD	회사정리
CPRRW	회사정리법
CPRND	회사채
WIRE	회선
OTSVCR	회송차
RTRVL	회수
RTVT	회수용기
RTVLMN	회수자
RPY	회시
RPLY	회신
RPLMN	회신자
MBER	회원
MBSCD	회원권
MSSM	회원제
MBRMV	회원제정보서비스
MGR	회유
MTG	회의
CHIRMN	회장
RTAT	회전
RTATE	회전
TRNOV	회전율
FTRN	회전차로
FTRL	회전차선
TME	회차
EVAS	회피
PICTRS	회화
PGDATR	회화나무
OBTAIN	획득
DMRC	획정
CO	횟수
CROSNG	횡단
CSSN	횡단경사
CRSLK	횡단보도
EMBZZL	횡령
FPTY	효
EFFECT	효과
ECD	효과음
EFCY	효능
FPTY	효도
EFECT	효력
ENZYME	효소
USF	효용
EFCTVL	효용가치
EFCNY	효율
EFFCY	효험
GUARDN	후견인
MENTORG	후견인제도
SCESR	후계자
LRPY	후급
AFTPMN	후납
LRGSCP	후두경
SHYY	후반기
CNDCY	후보
CADET	후보생
CNDDT	후보자
BACK	후부
SDF	후부수선
FRPY	후불
WELFR	후생
FLLW	후속
FLWK	후속작업
AORP	후순위권리자
SUPRT	후원
CNTB	후원금
SRLNC	후원수당
SPNSER	후원자
ADACTN	후원회
SQUL	후유증
SUCCSSER	후임자
LIFOM	후입선출법
SUARCAG	후착화물
PEPR	후추
ESCBRD	후행
ADMNT	훈계
TRAING	훈련
TRNEE	훈련생
DTRNG	훈련중
DRCTV	훈령
ADMN	훈시
ADMNR	훈시자
MEDAL	훈장
FMG	훈증
DAMAGE	훼손
BRTNSS	휘도
VLATIL	휘발성
VLNMS	휘발성유기화학물질
VGMS	휘발성유기화합물
GSLN	휘발유
VCATN	휴가
RESTRM	휴게실
CLOSE	휴관
CRYAL	휴대
HANCRGD	휴대반입물품
DFOCPE	휴대반입물품의명세서
COPEFT	휴대반출물품
DCOPE	휴대반출신고
PRTBL	휴대용
HCMDTOR	휴대용금속탐지기
PEEFCT	휴대용품
MOBLPHON	휴대전화
MOBLPHON	휴대전화기
MLMC	휴대통신
MOBLPHON	휴대폰
MBTLNUM	휴대폰번호
HBGG	휴대품
BAGINSP	휴대품검사
SUBGINS	휴대품검사관
PPES	휴대품과
SOBIS	휴대품과장
LIOPEET	휴대품목록
DFOPE	휴대품신고서
CSOHCGD	휴대품유치서
DOPPD	휴대품통관국장
DRMNCY	휴면
DRMNCYCMPNY	휴면회사
HVOF	휴무
RSTDE	휴무일
REST	휴식
RECRT	휴양
RCRFRST	휴양림
RCRFCT	휴양시설
RCRTCT	휴양지
SSS	휴업
SBSL	휴업수당
RESTDE	휴일
CSRL	휴전선
CFRG	휴전협정
PAUSE	휴지
PSMINE	휴지광산
LAYOFF	휴직
SPCSS	휴폐업
TMPABSSKL	휴학
ADJRNM	휴회
BHT	흉고
THRX	흉곽
WEPON	흉기
BRST	흉부
BRSHW	흉장
PCTRLG	흉통
FLOW	흐름
BLWH	흑백
BLPWDR	흑색화약
MARKS	흔적
DTLN	흘수선
DRSRH	흘수제약선
SHRTG	흠결
ABSRP	흡수
HGRSCP	흡습성
SMKNG	흡연
ASPRTR	흡인기
INHL	흡입
INTRST	흥미
SHENTP	흥행
RARE	희귀
RDCLNG	희롱
HOPE	희망
CDIDT	희망자
SCRIFC	희생
SCRCTBR	희생공헌자
VICTIM	희생자
VCJDG	희생자심사
RARN	희소
HTR	히터
HIT	히트
HINT	힌트
STNGTH	힘
CALF	송아지
FALLOW	휴경
FARM	농장
DP	피해보전
TREE_CO	주수
CBS	폐업지원
COW	소암컷
BULL	소수컷
OPS	유기질비료지원
PERNNL	영년생
SPR	판매촉진
VOW	서약
CBC	소브루셀라검사관리
PURCHS_N_BRD	입식
EAR_TAG	귀표
FND	밑거름
COMP	퇴비
K	칼리
PHSP_ACID	인산
FRTLZR_QY	시비량
DIE_OUT	도태
NH	농협
KFLC	축협
SILICIC	규산
ODAY	일일
ODAYRNTCHRG	일일임대료
SBSCRBMCHNCO	가입대수
ALOCTR	배정자
INDVDLZFRMHSALOCTRCO	개별농가배정자수
INDVDLZFRMHSAMOUNT	개별농가신청금액
MASURE	계측
OIL	오일
MEAST	계측
MODEL	기종
REFRIG	냉동
TRUCK	탑차
KOC	작목
ANSPIES	축종
SELECTOR	선별기
SHIPCO 	척
MAN	남
WOMAN	여
PCOLER	예냉고
KOO	유종
POCTPAYM 	자부담
STOROM	저장고
GROPRFTMARG	조수익
SACKMAKMCHNCNT	제함기
HEAVOIL	중유
GATHINGCENTR	집하선별장
AFTER	후
MARK	평점
KOF	비종
STMPOUT	살처분
POSTER	포스터
BANNER	현수막
INQRYRD	탐방로
MBOHD	세대원
GRPNG	집단화
LMNG	석회질
MALE	수컷
FEMALE	암컷
DRCTPT	직불
DFTPRMS	확약
INFLRS	개화
INTRCRPP	간작
SNGLCRPP	단작
HRVST	수확
SEED	파종
MXDCRPP	혼작
GRNM	녹비
YNGAN	자축
SEASON	절기
QLE	정성적
QTE	정량적
TAXXPTOIL	면세유
EXAMINTEM	조사반
